{
  "schema_version": 1,
  "map_id": 4,
  "size": [
    128,
    128
  ],
  "custom_map": [
    "00000000000000000000000000000000000000000000000000000000000000000000000000000000000000000000000000000000000000000000000000000000",
    "00000000000000000000000000000000000000000000000000000000000000000000000000000000000000000000000000000000000000000000000000000000",
    "00000000000000000000000000000000000000000000000000000000000000000000000000000000000000000000000000000000000000000000000000000000",
    "00000000000000000000000000000000000000000000000000000000000000000000000000000000000000000000000000000000000000000000000000000000",
    "00000000000000000000000000000000000000000000000000000000000000000000000000000000000000000000000000000000000000000000000000000000",
    "00000000000000000000000000000000000000000000000000000000000000000000000000000000000000000000000000000000000000000000000000000000",
    "00000000000000000000000000000000000000000000000000000000000000000000000000000000000000000000000000000000000000000000000000000000",
    "00000000000000000000000000000000000000000000000000000000000000000000000000000000000000000000000000000000000000000000000000000000",
    "00000000000000000000000000000000000000000000000000000000000000000000000000000000000000000000000000000000000000000000000000000000",
    "00000000000000000000000000000000000000000000000000000000000000000000000000000000000000000000000000000000000000000000000000000000",
    "00000000000000000000000000000000000000000000000000000000000000000000000000000000000000000000000000000000000000000000000000000000",
    "00000000000000000000000000000000000000000000000000000000000000000000000000000000000000000000000000000000000000000000000000000000",
    "00000000222222222222222222222222222222222222222222000000000000000000000000000000000000000000000000000000000000000000000000000000",
    "00000000222222222222222222222222222222222222222222000000000000000000000000000000000000000000000000000000000000000000000000000000",
    "00000000222222222222222222222222222222222222222222000000000000000000000000000000000000000000000000000000000000000000000000000000",
    "00000000222222222222222222222222222222222222222222000000000000000000000000000000000000000000000000000000000000000000000000000000",
    "00000000222222222222222222222222222222222222222222000000000000000000000000000000000000000000000000000000000000000000000000000000",
    "00000000222222222222222222222222222222222222222222000000000000000000000000000000000000000000000000000000000000000000000000000000",
    "00000000222222222222222222222222222222222222222222000000000000000000000000000000000000000000000000000000000000000000000000000000",
    "00000000222222222222222222222222222222222222222222000000000000000000000000000000000000000000000000000000000000000000000000000000",
    "00000000222222222222222222222222222222222222222222000000000000000000000000000000000000000000000000000000000000000000000000000000",
    "00000000222222222222222222222222222222222222222222000000000000000000000000000000000000000000000000000000000000000000000000000000",
    "00000000222222222222222222222222222222222222222222000000000000000000000000000000000000000000000000000000000000000000000000000000",
    "00000000222222222222222222222222222222222222222222000000000000000000000000000000000000000000000000000000000000000000000000000000",
    "00000000222222222222222222222222222222222222222222000000000000000000000000000000000000000000000000000000000000000000000000000000",
    "00000000222222222222222222222222222222222222222222000000000000000000000000000000000000000000000000000000000000000000000000000000",
    "00000000222222222222222222222222222222222222222222000000000000000000000000000000000000000000000000000000000000000000000000000000",
    "00000000222222222222222222222222222222222222222222000000000000000000000000000000000000000000000000000000000000000000000000000000",
    "00000000222222222222222222222222222222222222222222000000000000000000000000000000000000000000000000000000000000000000000000000000",
    "00000000222222222222222222222222222222222222222222000000000000000000000000000000000000000000000000000000000000000000000000000000",
    "00000000222222222222222222222222222222222222222222000000000000000000000000000000000000000000000000000000000000000000000000000000",
    "00000000222222222222222222222222222222222222222222000000000000000000000000000000000000000000000000000000000000000000000000000000",
    "00000000222222222222222222222222222222222222222222000000000000000000000000000000000000000000000000000000000000000000000000000000",
    "00000000222222222222222222222222222222222222222222000000000000000000000000000000000000000000000000000000000000000000000000000000",
    "00000000222222222222222222222222222222222222222222000000000000000000000000000000000000000000000000000000000000000000000000000000",
    "00000000222222222222222222222222222222222222222222000000000000000000000000000000000000000000000000000000000000000000000000000000",
    "00000000222222222222222222222222222222222222222222000000000000000000000000000000000000000000000000000000000000000000000000000000",
    "00000000222222222222222222222222222222222222222222000000000000000000000000000000000000000000000000000000000000000000000000000000",
    "00000000222222222222222222222222222222222222222222000000000000000000000000000000000000000000000000000000000000000000000000000000",
    "00000000222222222222222222222222222222222222222222000000000000000000000000000000000000000000000000000000000000000000000000000000",
    "00000000222222222222222222222222222222222222222222000000000000000000000000000000000000000000000000000000000000000000000000000000",
    "00000000222222222222222222222222222222222222222222000000000000000000000000000000000000000000000000000000000000000000000000000000",
    "00000000222222222222222222222222222222222222222222000000000000000000000000000000000000000000000000000000000000000000000000000000",
    "00000000222222222222222222222222222222222222222222000000000000000000000000000000000000000000000000000000000000000000000000000000",
    "00000000222222222222222222222222222222222222222222000000000000000000000000000000000000000000000000000000000000000000000000000000",
    "00000000222222222222222222222222222222222222222222000000000000000000000000000000000000000000000000000000000000000000000000000000",
    "00000000222222222222222222222222222222222222222222000000000000000000000000000000000000000000000000000000000000000000000000000000",
    "00000000222222222222222222222222222222222222222222000000000000000000000000000000000000000000000000000000000000000000000000000000",
    "00000000222222222222222222222222222222222222222222000000000000000000000000000000000000000000000000000000000000000000000000000000",
    "00000000222222222222222222222222222222222222222222000000000000000000000000000000000000000000000000000000000000000000000000000000",
    "00000000222222222222222222222222222222222222222222000000000000000000000000000000000000000000000000000000000000000000000000000000",
    "00000000222222222222222222222222222222222222222222000000000000000000000000000000000000000000000000000000000000000000000000000000",
    "00000000222222222222222222222222222222222222222222000000000000000000000000000000000000000000000000000000000000000000000000000000",
    "00000000222222222222222222222222222222222222222222000000000000000000000000000000000000000000000000000000000000000000000000000000",
    "00000000222222222222222222222222222222222222222222222222222222222222222222222222220000000000000000000000000000000000000000000000",
    "00000000222222222222222222222222222222222222222222222222222222222222222222222222220000000000000000000000000000000000000000000000",
    "00000000222222222222222222222222222222222222222222222222222222222222222222222222220000000000000000000000000000000000000000000000",
    "00000000222222222222222222222222222222222222222222222222222222222222222222222222220000000000000000000000000000000000000000000000",
    "00000000000000000000000000000000000000000000000022222222222222222222222222222222220000000000000000000000000000000000000000000000",
    "00000000000000000000000000000000000000000000000000000000000000000000000000000222220000000000000000000000000000000000000000000000",
    "00000000000000000000000000000000000000000000000000000000000000000000000000000222220000000000000000000000000000000000000000000000",
    "00000000000000000000000000000000000000000000000000000000000000000000000000000222220000000000000000000000000000000000000000000000",
    "00000000000000000000000000000000000000000000000000000000000000000000000000000222220000000000000000000000000000000000000000000000",
    "00000000000000000000000000000000000000000000000000000000000000000000000000000222220000000000000000000000000000000000000000000000",
    "00000000000000000000000000000000000000000000000000000000000000000000000000000222220000000000000000000000000000000000000000000000",
    "00000000000000000000000000000000000000000000000000000000000000000000000000000222220000000000000000000000000000000000000000000000",
    "00000000000000000000000000000000000000000000000000000000000000000000000000000222220000000000000000000000000000000000000000000000",
    "00000000000000000000000000000000000000000000000000000000000000000000000000000222220000000000000000000000000000000000000000000000",
    "00000000000000000000000000000000000000000000000000000000000000000000000000000222220000000000000000000000000000000000000000000000",
    "00000000000000000000000000000000000000000000000000000000000000000000000000000222220000000000000000000000000000000000000000000000",
    "00000000000000000000000000000000000000000000000000000000000000000000000000000222222222222222222222222222222222222222222200000000",
    "00000000000000000000000000000000000000000000000000000000000000000000000000000222222222222222222222222222222222222222222200000000",
    "00000000000000000000000000000000000000000000000000000000000000000000000000000222222222222222222222222222222222222222222200000000",
    "00000000000000000000000000000000000000000000000000000000000000000000000000000222222222222222222222222222222222222222222200000000",
    "00000000000000000000000000000000000000000000000000000000000000000000000000000222222222222222222222222222222222222222222200000000",
    "00000000000000000000000000000000000000000000000000000000000000000000000000000222222222222222222222222222222222222222222200000000",
    "00000000000000000000000000000000000000000000000000000000000000000000000000000022222222222222222222222222222222222222222200000000",
    "00000000000000000000000000000000000000000000000000000000000000000000000000000022222222222222222222222222222222222222222200000000",
    "00000000000000000000000000000000000000000000000000000000000000000000000000000022222222222222222222222222222222222222222200000000",
    "00000000000000000000000000000000000000000000000000000000000000000000000000000022222222222222222222222222222222222222222200000000",
    "00000000000000000000000000000000000000000000000000000000000000000000000000000022222222222222222222222222222222222222222200000000",
    "00000000000000000000000000000000000000000000000000000000000000000000000000000022222222222222222222222222222222222222222200000000",
    "00000000000000000000000000000000000000000000000000000000000000000000000000000022222222222222222222222222222222222222222200000000",
    "00000000000000000000000000000000000000000000000000000000000000000000000000000022222222222222222222222222222222222222222200000000",
    "00000000000000000000000000000000000000000000000000000000000000000000000000000022222222222222222222222222222222222222222200000000",
    "00000000000000000000000000000000000000000000000000000000000000000000000000000022222222222222222222222222222222222222222200000000",
    "00000000000000000000000000000000000000000000000000000000000000000000000000000022222222222222222222222222222222222222222200000000",
    "00000000000000000000000000000000000000000000000000000000000000000000000000000022222222222222222222222222222222222222222200000000",
    "00000000000000000000000000000000000000000000000000000000000000000000000000000022222222222222222222222222222222222222222200000000",
    "00000000000000000000000000000000000000000000000000000000000000000000000000000022222222222222222222222222222222222222222200000000",
    "00000000000000000000000000000000000000000000000000000000000000000000000000000022222222222222222222222222222222222222222200000000",
    "00000000000000000000000000000000000000000000000000000000000000000000000000000022222222222222222222222222222222222222222200000000",
    "00000000000000000000000000000000000000000000000000000000000000000000000000000022222222222222222222222222222222222222222200000000",
    "00000000000000000000000000000000000000000000000000000000000000000000000000000022222222222222222222222222222222222222222200000000",
    "00000000000000000000000000000000000000000000000000000000000000000000000000000022222222222222222222222222222222222222222200000000",
    "00000000000000000000000000000000000000000000000000000000000000000000000000000022222222222222222222222222222222222222222200000000",
    "00000000000000000000000000000000000000000000000000000000000000000000000000000022222222222222222222222222222222222222222200000000",
    "00000000000000000000000000000000000000000000000000000000000000000000000000000022222222222222222222222222222222222222222200000000",
    "00000000000000000000000000000000000000000000000000000000000000000000000000000022222222222222222222222222222222222222222200000000",
    "00000000000000000000000000000000000000000000000000000000000000000000000000000022222222222222222222222222222222222222222200000000",
    "00000000000000000000000000000000000000000000000000000000000000000000000000000022222222222222222222222222222222222222222200000000",
    "00000000000000000000000000000000000000000000000000000000000000000000000000000022222222222222222222222222222222222222222200000000",
    "00000000000000000000000000000000000000000000000000000000000000000000000000000022222222222222222222222222222222222222222200000000",
    "00000000000000000000000000000000000000000000000000000000000000000000000000000022222222222222222222222222222222222222222200000000",
    "00000000000000000000000000000000000000000000000000000000000000000000000000000022222222222222222222222222222222222222222200000000",
    "00000000000000000000000000000000000000000000000000000000000000000000000000000022222222222222222222222222222222222222222200000000",
    "00000000000000000000000000000000000000000000000000000000000000000000000000000022222222222222222222222222222222222222222200000000",
    "00000000000000000000000000000000000000000000000000000000000000000000000000000022222222222222222222222222222222222222222200000000",
    "00000000000000000000000000000000000000000000000000000000000000000000000000000022222222222222222222222222222222222222222200000000",
    "00000000000000000000000000000000000000000000000000000000000000000000000000000022222222222222222222222222222222222222222200000000",
    "00000000000000000000000000000000000000000000000000000000000000000000000000000022222222222222222222222222222222222222222200000000",
    "00000000000000000000000000000000000000000000000000000000000000000000000000000022222222222222222222222222222222222222222200000000",
    "00000000000000000000000000000000000000000000000000000000000000000000000000000022222222222222222222222222222222222222222200000000",
    "00000000000000000000000000000000000000000000000000000000000000000000000000000022222222222222222222222222222222222222222200000000",
    "00000000000000000000000000000000000000000000000000000000000000000000000000000022222222222222222222222222222222222222222200000000",
    "00000000000000000000000000000000000000000000000000000000000000000000000000000022222222222222222222222222222222222222222200000000",
    "00000000000000000000000000000000000000000000000000000000000000000000000000000000000000000000000000000000000000000000000000000000",
    "00000000000000000000000000000000000000000000000000000000000000000000000000000000000000000000000000000000000000000000000000000000",
    "00000000000000000000000000000000000000000000000000000000000000000000000000000000000000000000000000000000000000000000000000000000",
    "00000000000000000000000000000000000000000000000000000000000000000000000000000000000000000000000000000000000000000000000000000000",
    "00000000000000000000000000000000000000000000000000000000000000000000000000000000000000000000000000000000000000000000000000000000",
    "00000000000000000000000000000000000000000000000000000000000000000000000000000000000000000000000000000000000000000000000000000000",
    "00000000000000000000000000000000000000000000000000000000000000000000000000000000000000000000000000000000000000000000000000000000",
    "00000000000000000000000000000000000000000000000000000000000000000000000000000000000000000000000000000000000000000000000000000000",
    "00000000000000000000000000000000000000000000000000000000000000000000000000000000000000000000000000000000000000000000000000000000",
    "00000000000000000000000000000000000000000000000000000000000000000000000000000000000000000000000000000000000000000000000000000000",
    "00000000000000000000000000000000000000000000000000000000000000000000000000000000000000000000000000000000000000000000000000000000",
    "00000000000000000000000000000000000000000000000000000000000000000000000000000000000000000000000000000000000000000000000000000000"
  ],
  "agent_spawn_pool": [
    [
      14,
      20
    ],
    [
      18,
      52
    ],
    [
      118,
      112
    ]
  ],
  "npc_spawn_pool": [
    [
      52,
      56
    ],
    [
      66,
      56
    ],
    [
      79,
      64
    ],
    [
      79,
      73
    ]
  ],
  "station_pool": [
    {
      "x": 12,
      "z": 16,
      "dx": 3,
      "dz": 3
    },
    {
      "x": 42,
      "z": 50,
      "dx": 3,
      "dz": 3
    },
    {
      "x": 82,
      "z": 74,
      "dx": 3,
      "dz": 3
    },
    {
      "x": 112,
      "z": 110,
      "dx": 3,
      "dz": 3
    }
  ],
  "max_battery": 200,
  "max_steps": 1000,
  "hero_id": 37,
  "npc_ids": null,
  "local_view_size": 21
}
