{
  "schema_version": 1,
  "map_id": 5,
  "size": [
    128,
    128
  ],
  "custom_map": [
    "00000000000000000000000000000000000000000000000000000000000000000000000000000000000000000000000000000000000000000000000000000000",
    "00000000000000000000000000000000000000000000000000000000000000000000000000000000000000000000000000000000000000000000000000000000",
    "00000000002222222000000000000000000000000000000000000000000000000000000000000000000000000000000000000000000000000000000000000000",
    "00000000002222222000000000000000000000000000000000000000000000000000000000000000000000000000000000000000000000000000000000000000",
    "00000000002222222000000000000000000000000000000000000000000000000000000000000000000000000000000000022222222222222222000000000000",
    "00000000002222222000000000000000000000000000000000000000000000000000000000000000000000000000000000022222222222222222220000000000",
    "00000000002222222000000000000000000000000000000000000000000000000000000000000000000000000000000000022222222222222222220000000000",
    "00000000002222222000000000000000000000000000000000000000000000000000000000000000000000000000000000022222222222222222220000000000",
    "00000000002222222000000000000000000000000000000000000000000000000000000000000000000000000000000000022222222222222222220000000000",
    "00000000002222222000000000000000000000000000000000000000000000000000000000000000000000000000000000022222222222222222220000000000",
    "00000000002222222222222222222220000000000000000000000000000000000000000000000000000000000000000000022222222222222222220000000000",
    "00000000002222222222222222222220000000000000000000000000000000000000000000000000000000000000000000022222222222222222220000000000",
    "00000000002222222222222222222222000000000000000000000000000000000000000000000000000000000000000000022222222222222222220000000000",
    "00000000002222222222222222222222000000000000000000000000000000000000000000000222222222222222222222222222222222222222220000000000",
    "00000000002222222222222222222222002222220000000000000000000000000000000000000222222222222222222222222222222222222222220000000000",
    "00000000002222222222222222222222222222220000000000000000000000000000000000000022222222222222222222222222222222222222220000000000",
    "00000000002222222222222222222222222222220000000000000000000000000000000000000022222222222222222222222222222222222222220000000000",
    "00000000002222222222222222222222222222220000000000000000000000000000000000000022222222222222222222222222222222222222220000000000",
    "00000000002222222222222222222222222222222002000002222000020000000000000000000022222222222222222222222222222222222222220000000000",
    "00000000002222222222222222222222222222222222222222222222222220000000000222222222222222222222222222222222222222222222220000000000",
    "00000000002222222222222222222222222222222222222222222222222220000000000222222222222222222222222222222222222222222222222000000000",
    "00000000002222222222222222222222222222222222222222222222222220000000000222222222222222222222222222222222222222222222222000000000",
    "00000000002222222222222222222222222222222222222222222222222220000000000222222222222222222222222222222222222222222222220000000000",
    "00000000002222222222222222222222222222222222222222222222222220000000000222222222222222222222222222222222222222222222220000000000",
    "00000000002222222222222222222222222222222222222222222222222220000000000222222222222222222222220222222222222222222222220000000000",
    "00000000002222222222222222222222222222222222222222222222222220000000002222222222222222222222222222222222222222222222220000000000",
    "00000000002222222222222222222222222222222222222222222222222222222222222222222222222222222222222222022222222222222222220000000000",
    "00000000002222222222222222222222222222222222222222222222222222222222222222222222222222222222222222222222222222222222222220000000",
    "00000000002222222222222222222222222222222222222222222222222222222222222222222222222222222222222222222202222222222222222220000000",
    "00000000002222222222222222222222222222222222222222222222222222222222222222222222222222222222222222222222222222222222222220000000",
    "00000000002222222222222222222222222222222222222222222222222222222222222222222222222222222222222222222222222222222222222220000000",
    "00000000002222222222222222222222222222222222222222222222222222222222222222222222222222222222222222222222222222222222222220000000",
    "00000000002222222222222222222222222222222222222222222222222222222222222222222222222222222222222222222222222222222222222220000000",
    "00000000002222222222222222222222222222222222222222222222222222222222222222222222222222222222222222222222222222222222222220000000",
    "00000000002222222222222222222222000000000000000000002222222222222222222222222222222222222222222222222222222222222222222220000000",
    "00000000002222222222222222222222000000000000000000002222222222222222222222222222222222222222222222222222222222222222222220000000",
    "00000000002222222222222222222222000000000000000000002222222222000000000000000022222220000000000000000000022222222222222220000000",
    "00000000002222222222222222222222000000000000000000002222222222000000000000000222222220000000000000000000022222222222222220000000",
    "00000000002222222222222222222220000000000000000000002222222222000000000000000222222220000000000000000000022222222222222220000000",
    "00000000002222222222222222222200000000000000000000002222222222000000000000000222222220000000000000000000022222222222222220000000",
    "00000000000222222222222222222200000000000000000000002222222222200000000000000222222220000000000000000000022222222222222220000000",
    "00000000000022222222222222222000000000000000000000002222222222200000000000000222222220000000000000000000222222222222222220000000",
    "00000000000002222222222222220000000000000000000000002222222222200000000000000222222220000000000000000000222222222222200000000000",
    "00000000000022222222222222200000000000000000000000002222222222000000000000000222222220000000000000000000222222222222200000000000",
    "00000000000022220222222222200000000000000000000000002222222222000000000000000222222220000000000000000000222222222222000000000000",
    "00000000000022222222222222200000000000000000000000002222222222000000000000000222222220000000000000000000222222222222000000000000",
    "00000000000022222222222222000000000000000000000000002222222222222222222222222222222220000000000000000000222222222222000000000000",
    "00000000000022222200000000000000000000000000000000002222222222222222222222222222222220000000000000000000222222222222000000000000",
    "00000000000022222200000000000000000222222222222222222222222222222222222222222222222220000000000000000000022222222222000000000000",
    "00000000000022222200000000000000000222222222222222222222222222222222222222222222222220000000000000000000022222222222000000000000",
    "00000000000022222200000000000000000222222222222222222222222222222222222222222222222220000000000000000000022222222222000000000000",
    "00000000000022222222222000000000000222222222222222222222222222222222222222222222222220000000000000000000022222222222000000000000",
    "00000000222222222222220200000000000222222222222222222222222222222222222222222222222220000000000000000000022222222222000000000000",
    "00000000222222222222222200000000000222222222222222222222222222222222222222222222222220000000000000000000022222222222000000000000",
    "00000000222222222222222202222222222222222222222222222222222222222222200000000000000000000000000000000000022222222222000000000000",
    "00000000222222222222222222222222222222222200000000000002222222222222000000000000000000000000000000000002222222222222000000000000",
    "00000000222222222222222222022222222222222200000000000002222222222220000000000000000000000000000000000002222222222222000000000000",
    "00000000222222222222222222222222222222222200000000000002222222222220000000000000000000022222222222222222222222222222000000000000",
    "00000000222222222202222222222222222222222200000000000002222222222220000000000000000022222222222222222222222222222222000000000000",
    "00000000222222222222222222222222222222222000000000000002222222222220000000000000000022222222222222222222222222222222000000000000",
    "00000000222222222222220222222222222222222000000000000022222222222220000000000000000022222222222222222222222222222222000000000000",
    "00000000222222222222222222222222222222220000000000000022222222222220000000000000000022222222222222222222222222222222000000000000",
    "00000000222222222222222222022222222222200000000000000022222222222220000000000000000022222222222222222222222222222222222220000000",
    "00000000022222222222222222220000000000000000000000000022222222222220000000000000000022222222222222222222222222222222222220000000",
    "00000000000000000022222222220000000000000000000000000022222222222220000000000000000022222222222222222222222222222222222220000000",
    "00000000000000000000022222220000000000000000000000000022222222222220000000000000000022222222222222222222222222222222222220000000",
    "00000000000000000000022222220000000000000000000000000022222222222220000000000000000022222222222222222222222222222222222220000000",
    "00000000000000000000022222220000000000000000000000000002222222222220000000000000000022222222222222222222222222222222222220000000",
    "00000000000000000000022222220000000000000000000000000002222222222220000000000000000022222222222222222222222222222222222220000000",
    "00000000000000000000022222220000000000000000000000000002222222222220000000000000000022222222222222222222222222222222222220000000",
    "00000000000000000000022222220000000000000000000000000002222222222220000000000000000022222222222222222222222222222222222220000000",
    "00000000000000000000022222222200000000000000000000002222222222222220000000000000000022222222000002222222222222222222222220000000",
    "00000000000000022222222222222220000000000000000000002222222222222220000000000000000022222222000002222222222222222222222220000000",
    "00000000000000022222222222222220000000000000000000002222222222222220000000000000000022222222000002222222222222222222222220000000",
    "00000000000022222222222222222222200000000000000000002222222222222220000000000000000022222222000002222222222222222222222220000000",
    "00000000000222222222222222222222220000000000000000002222222222222220000000000000000022222222000002222222222222222222222220000000",
    "00000000000222222222222222222222220000000000000000002222222222222220000000000000000022222222000002222222222222222222222220000000",
    "00000000000222222222222222222222220000000000000002222222222222222222000000000000000022222222000002222222222222222222222220000000",
    "00000000000222222222222222222222220000000000000002222222222222222222222222222222222222222222000002222222222222222222222220000000",
    "00000000000222222222222222222222220000000000000002222222222222222222222222222222222222222222000002222222222222222222222220000000",
    "00000000000222222222222222222222220000000000000002222222222222222222222222222222222222222222000002222222222222222222222220000000",
    "00000000000222222222222222222222222000000000000002222222222222222222222222222222222222222222000002222222222222222222222220000000",
    "00000000000222222222222222222222222000000000000000222222222222222222222222222222222222222222000002222222222222222222222220000000",
    "00000000000222222222222222222222222000000000000000222222222222222222222222222222222222222222000002222222222222222222222220000000",
    "00000000000222222222222222222222222000000000000000222222222220000000000022222222222222222222000002222222222222222222000000000000",
    "00000000000222222222222222222222222000000000000000222222222200000000000002222222222222222222000002222222222222222222000000000000",
    "00000000000222222222222222222222222000000000000000022222222200000000000002222222222222222222000000000000202222222222000000000000",
    "00000000000222222222222222222222222000000000000000000002222200000000000002222222222222222222000000000000000222222220000000000000",
    "00000000000022222222222222222222222000000000000000000002222200000000000002222222222222222222000000000000000022222200000000000000",
    "00000000000022222222222222222222222000000000000000000002222200000000000002222222222222222222000000000000000022222200000000000000",
    "00000000000022222222222222222222222000000000000000000002222200000000000002222222222222222222000000000000000022222200000000000000",
    "00000000000022222222222222222222000000000000000000000002222200000000000002222222222222222222000000000000000022222200000000000000",
    "00000000000022222222222222222220000000000000000000000002222200000000000002222222222222222222000000000000000022222200000000000000",
    "00000000000022222222222222222220000000000000000000000002222200000000000002222222222222222222000000000000000022222200000000000000",
    "00000000000022222222222222222220000000000000000000000002222200000000000002222222222222222222000000000000000022222200000000000000",
    "00000000000222222222222222222220000000000000000000000002222200000000000002222222222222222222000000000000000022222200000000000000",
    "00000000000222222222222222222220000002222220000000000002222200000000000002222222222222222222000000000000000022222200000000000000",
    "00000000000222222222222222222220000002222222000000000002222200000000000002222222222222222222000000000000000022222200000000000000",
    "00000000000222222222222222222222200002222222000000000002222200000000000002222222222222222222000000000000000022222200000000000000",
    "00000000000222222222222222222222222222222222000000000002222200000000000002222222222222222222000000000000000022222200000000000000",
    "00000000000222222222222222222222222222222222000000000002222200000000000002222222222222222222000000000000000022222200000000000000",
    "00000000000222222222222222222222222222222222000000000002222200000000000002222222222222222222200000000000000022222200000000000000",
    "00000000000222222202222222222222222222222222000000000002222200000000000022222222222222222222200000000000000022222200000000000000",
    "00000000000222222222222222222222222222222222000000000002222220000000000022222222200000222222000000000000000022222200000000000000",
    "00000000000222222222222222222222222222222222000000000002222222222222200222222222200000000000000000000000000022222200000000000000",
    "00000000000222222222222222222222222222222222000000000002222222222222222222222222200000000000000000000000000022222200000000000000",
    "00000000002222222222220222222222222222222222000000000002222222222222222222222222200000000000000000000000000022222200000000000000",
    "00000000022222222222222222222222222222222222000000000002222222222222222222222222200000000000000000000000000022222200000000000000",
    "00000000222222222222222222222222222222222220000000000002222222222222222222222222200000000000000000000000000022222200000000000000",
    "00000002222222222222222222222222222222222222200000222222222222222222222222222222222000000000000000000000000022222200000000000000",
    "00000002222222222222222222022222222222222222222222222222222222222222222222222222222000000000000000000000000022222200000000000000",
    "00000002222222222222222222222222222222222222222222222222222222222222222222222222222000000000000000000000000022222200000000000000",
    "00000002222222222222222222222222222222222222222222222222222222222222222222222222222222222222222222222222222222222200000000000000",
    "00000002222222222222222222222222222222222222222222222222222222222222222222222222222222222222222222222222222222222200000000000000",
    "00000002222222222222222222222222222222222222222222222222222222222222222222222222222222222222222222222222222222222200000000000000",
    "00000002222222222222222222222222222222222222222222222222222222222222222222222222222222222222222222222222222222222000000000000000",
    "00000002222222222222222222222222222222222222222222222222222222222222222222222222222200000000000000000000000000000000000000000000",
    "00000002222222222222222222222222222222222222222222222222222222222222222222222222222200000000000000000000000000000000000000000000",
    "00000002222222222222222222222222222222222222222222222222222222222222222222222222222200000000000000000000000000000000000000000000",
    "00000002222222222222222222222222222222222222222222222222222222222222222222222222222200000000000000000000000000000000000000000000",
    "00000002222222222222222222222222222222222222222222222222222222222222222222222222222000000000000000000000000000000000000000000000",
    "00000002222222222222222222222222222222222222222222222222222222222222222222220000000000000000000000000000000000000000000000000000",
    "00000000000000000002222222222222222222222000000000000000000002222222222222220000000000000000000000000000000000000000000000000000",
    "00000000000000000000000000000000000000000000000000000000000000000000000000000000000000000000000000000000000000000000000000000000",
    "00000000000000000000000000000000000000000000000000000000000000000000000000000000000000000000000000000000000000000000000000000000",
    "00000000000000000000000000000000000000000000000000000000000000000000000000000000000000000000000000000000000000000000000000000000",
    "00000000000000000000000000000000000000000000000000000000000000000000000000000000000000000000000000000000000000000000000000000000",
    "00000000000000000000000000000000000000000000000000000000000000000000000000000000000000000000000000000000000000000000000000000000"
  ],
  "agent_spawn_pool": [
    [
      12,
      12
    ],
    [
      112,
      112
    ],
    [
      112,
      4
    ]
  ],
  "npc_spawn_pool": [
    [
      58,
      64
    ],
    [
      84,
      86
    ],
    [
      96,
      34
    ],
    [
      28,
      94
    ]
  ],
  "station_pool": [
    {
      "x": 14,
      "z": 92,
      "dx": 3,
      "dz": 3
    },
    {
      "x": 28,
      "z": 92,
      "dx": 3,
      "dz": 3
    },
    {
      "x": 55,
      "z": 92,
      "dx": 3,
      "dz": 3
    },
    {
      "x": 57,
      "z": 92,
      "dx": 3,
      "dz": 3
    }
  ],
  "max_battery": 200,
  "max_steps": 1000,
  "hero_id": 37,
  "npc_ids": null,
  "local_view_size": 21
}
