{
  "schema_version": 1,
  "map_id": 7,
  "size": [
    128,
    128
  ],
  "custom_map": [
    "00000000000000000000000000000000000000000000000000000000000000000000000000000000000000000000000000000000000000000000000000000000",
    "00000000000000000000000000000000000000000000000000000000000000000000222222222000000000000000000000000000000000000000000000000000",
    "00000000000000000000000000000000000000000000000000000000000000000002222222222200000000000000000000000000000000000000000000000000",
    "00000000000000000000000000000000000000000000000000000000000000000002222222222220000000000000000000000000000000000000000000000000",
    "00000000000000000000000000000000000000000000000000000000000000000022222222222220000000000000000000000000000000000000000000000000",
    "00000000000000000000000000000000000000000000000000000000000000000022222222222222000000000000000000000000000000000000000000000000",
    "00000000000000000000000000000000000000000000000000000000000000000222222222222222000000000000000000000000000000000000000000000000",
    "00000000000000000000000000000000000000000000000000000000000000000222222222222222000000000000000000000000000000000000000000000000",
    "00000000000000000000000000000000000000000000000000000000000000000222222222222222000000000000000000000000000000000000000000000000",
    "00000000000000000000000000000000000000000000000000000000000000000222222222222222000000000000000000000000000000000000000000000000",
    "00000000000000000000000000000000000000000000000000000000000000000222222222222222222222222222222222222222000000000000000000000000",
    "00000000000000000000000000000000000000000000000000000000000000000222222222222222222222222222222222222222000000000000000000000000",
    "00000000000000000000000000000000000000000000000000000000000000000222222222222222222222222222222222222222200000000000000000000000",
    "00000000000000000000000000000000000000000000000000000000000000000222222222222222222222222222222222222222220000000000000000000000",
    "00000000000000000000000000000000000000000000000000000000000000000222222222222222222222222222222222222222222000000000000000000000",
    "00000000000000000000000000000000000000000000000000000000000000000222222222222222222222222222222220022222222200000000000000000000",
    "00000000000000000000000000000000000000000000000000000000000000000222222222222222222222222222222220002222222220000000000000000000",
    "00000000000000000000000000000000000000000000000000000000000000000222222222222222222222222222222220002222222222000000000000000000",
    "00000000000000000000000000000000000000000000000000000000000000000222222222222222222222222222222220000222222222200000000000000000",
    "00000000000000000000000000000000000000000000000000000000000000000222222222222222222222222222222220000222222222220000000000000000",
    "00000000000000000000000000000000000000000000000000000000000000000222222222222222222222222222222220000222222222222000000000000000",
    "00000000000000000000000000000000000000000000000000000000000000000222222222222222222222222202222220000022222222222200000000000000",
    "00000000000000000000000000000000000000000000000000002222222222222222222222222222000000000002222222000022222222222220000000000000",
    "00000000000000000000000000000000000000000000000002222222222222222222222222222222000000000002222222200002222222222222000000000000",
    "00000000000000000000000000000000000000000000002222222222222222222222222222222222000000000002222222200000222222222222000000000000",
    "00000000000000000000000000000000000000000000222222222222222222222222222222222222000000000002222222000000022222222222200000000000",
    "00000000000000000000000000000000000000000222222222222222222222222222222222222222000000000002222222200000002222222222220000000000",
    "00000000000000000000000000000000000222222222222222222222222222222222222022222222000000000000222222220000000000222222222000000000",
    "00000000000000000000000000000000000222222222222222222222222222222222220022222222000000000000022222222222222222222222222000000000",
    "00000000000000000000000000000000000222222222222222222222222222222222220022222222000000000000000022222222222222222222222000000000",
    "00000000000000000000000000000000000222222222222222222222222222200000000022220000000000000000000222222222222222222222222000000000",
    "00000000000000000000000000000000000222222222222222222222222222200000000222220000000000000000000222222222222222222222222000000000",
    "00000000000000000000000000000000000222222222222222222222222222200000000222220000000000000000000022222222222222222222222000000000",
    "00000000000000222222222222222222200222222222222222222222222222200000000222220000000000000000000002222222222222222222222000000000",
    "00000000000000222222222222222222200222222222222222222222222222200000002222220000000000000000000000022222222222222222222000000000",
    "00000000000000222222222222222222200222222222222200022222222222200000002222220000000000000000000000022222222222222222222000000000",
    "00000000000000222222222222222222200222222222222200022222222222200000002222220000000000000000000000022222222222222222222000000000",
    "00000000000000222222222222222222200222222222222200000000000000000000002222220000000022220000000000022222222222222222222000000000",
    "00000000000000222222222222222222200222222222222200000000000000000000022222220000000222222200000000022222222222222222222000000000",
    "00000000000000222222222222222222200222222222220000000000000000000000022222220000000222222222000000022222222222222222222000000000",
    "00000000000000222222222222222222200222222222220000000000000000000022222222220000000222222222222222222222222222222222222000000000",
    "00000022222222222222222222222222202222222222220000000000000000022222222222222000000222222222222222222222222222222222222000000000",
    "00000022222222222222222222222222222222222222220000000000000222222222222222222000000222222222222222222222222222222222220000000000",
    "00000022222222222222222222222222222222222222220000000000022222222222222222222200000222222222222222222222222222222222220000000000",
    "00000022222222222222222222222222222222222222220000000000222222222222222222222200000222222222222222222222222222222222220000000000",
    "00000022222222222222222222222222222222222222220000000000222222222222222222222200000222222222222222222222222222222222220000000000",
    "00000022222222222222222222222222222222222222220000000000222222222222222222222200000222222222222222222222222222222222220000000000",
    "00000022222222222222222222222222222222220000000000000000222222222222222222222200000222222222200000000222222222222222220000000000",
    "00000022222222222222222222222222222222220000000000000000222222222222222222222200000222222222200000000222222222222222220000000000",
    "00000022222222222222222222222222202222220000000000000000222222222222000002222200000222222222200000000222222222222222220000000000",
    "00000022222222222222222222222222200222220000000000000000222222222200000002222200000222222222200000000222222222222222220000000000",
    "00000022222222222222222222222222200222220000000000000000222222220000000002222222222222222222200000000222222222222222220000000000",
    "00000022222222222222222222222222200222220000000000000000222222200000000002222222222222222222200000000222222222222222220000000000",
    "00000022222222222222222222222222200222220000000000000000222200000000000002222222222222222222200000000222222220000000000000000000",
    "00000022222222222222222222222222200222220000000000000000222200000000000002222222222222222222200000000222222220000000000000000000",
    "00000022222222222222222222222222200222220000000000000000222200000000000002222222222222222222200000000222222220222222222200000000",
    "00000022222222222222222222222222200000000000000000000000222200000000000000000000000000222222200000000222222220222222222220000000",
    "00000022222222222222222222222222200000000000000000000000222200000000000000000000000002222222200000000222222220222222222222000000",
    "00000022222222222222222222220222200000000000000222222222222222222220000000000000000022222222200000222222222222222222222222200000",
    "00000022222222222220000000000222200000000000000222222222222222222220000000000000000022222222200000222222222222222222222222220000",
    "00000022222222222220000000022222200000000000000222222222222222222220000000000000000022222222200000222222222222222222222222222000",
    "00000022222222222220000000022222220000000000000222222222222222222220000000000000000022222222200000222222222222222222222222222200",
    "00000022222222222220000000022222222222222222222222222222222222222220000000000000000022222222222200222222222222222222222222222200",
    "00000022222222222220000000022222222222222222222222222222222222222220000000000000000022222222222200002222222222222222222222222220",
    "00000022222222222220000000022222222222222222222222222222222222222220000222222222222222222222222200000002222222222222222222222220",
    "00000022222222222220000000022222222222222222222222222222222222222220000222222222222222222222222200000000022222222222222222222220",
    "00000022222222222222000000022222222222222222222222222222222222222220000222222222222222222222222200000000000022222222222222222220",
    "00000022222222222222000000022222222222222222222222222222222222222220000222222222222222222222222200000000000000222222222222222220",
    "00000222222222222222000000022222222222222222222222000000000000002222000222222222222222222222222200000000000000000222222222222220",
    "00002222222222222222000000000000000000222222222222000000000000022222000222222222222222222222222200000000000000000222222222222220",
    "00022222222222222222000000000000000000022222222222000000002222222222000222222222222222222222222200022222200000022222222222222200",
    "00022222222222222222000000000000000000000222222222000000002222222222222222222200222222222222222200022222200022222222222222222200",
    "00222222222222222222000000000000000000000000000000000000002222222222222222222200000000000222222222222222222222222222222222222000",
    "02222222222222222220000000000000000000000000000000000000002222222222222222222200000000000222222222222222222222222222222222220000",
    "02222222222222222220000000000000000000000000000000000000002222222222222222222200000000000222222222222222222222222222222222220000",
    "02222222222222222220000000000000000000000000000000000000002222222222222222222222220000000222222222222222222222222222222222200000",
    "02222222222222222220000000000000000000000000000000000000002222222222222222222222220000000222222222222222222222222222222222000000",
    "02222222222222222220000000000000000000000000000000000000002222222222222222222222220000000222222222222222222222222222222222000000",
    "00000022222222222220000000000000000000000000000222222222222222222222222222222222220000000222222222222222222222222222222220000000",
    "00000022222222222220000000000000000000000000000222222222222222222222222222222222220000000222222222222222222002222222222200000000",
    "00000022222222222220000000000000000000000000000222222222222222222222222222222222220000000222222222222222222002222222222200000000",
    "00000022222222222220000000000000000000000000000222222222222222222222222222222222220000000222222222222000000000000000000000000000",
    "00000022222222222220000000000000000000000000000222222222222222222222222222222222220000000222222222220000000000000000000000000000",
    "00000022222222222220000000000000000000000000000222222222222222222222222222222222220000000222222222200000000000000000000000000000",
    "00000022222222222220000000000000000000000000000222222222222222222222222222222222220000000222222222200000000000000000000000000000",
    "00000022222222222220000000000000000000000000000222222222000022222222222222222222220000000222222222200000000000000000000000000000",
    "00000022222222222220000000000000000000000000000222222222000002222222222222222222220000000222222222200000000000000000000000000000",
    "00000022222222222220000000000000000000000000000222222222200000222222222222222222200000000222222222200000000000000000000000000000",
    "00000022222222222220000000000000000000000000000222222222200000022222222222222200000000000222222222220000000000000000000000000000",
    "00000022222222222220000000000000000000000000000222222222000000002222222222222200000000000222222222220000000000000000000000000000",
    "00022222222222222222222222222222222222222220000222222222000000000000000022222200000000000222222222220000000000000000000000000000",
    "00222222222222222222222222222222222222222220000222222222000000000000022222222222222222200222222222220000000000000000000000000000",
    "00222222222222222222222222222222222222222220000222222222000000000000222222222222222222200222222222220000000000000000000000000000",
    "00222222222222222222222222222222222222222220000222222222220000000000222222222222222222200222222222220000000000000000000000000000",
    "00222222222222222222222222222222222222222220000222222222220000000000222222222222222222200222222222220000000000000000000000000000",
    "00222222222222222222222222222222222222222220000222222222220000000000222222222222222222200222222222220000000000000000000000000000",
    "00222222222222222222222222222222222222222220000222222222220000000000022222222222222222200222222222220000000000000000000000000000",
    "00222222222222222222222222222222222222222220000222222222220000000000000000000000000222200222222222220000000000000000000000000000",
    "00222222222222222222222220000022222222222220000222222222220002222222000000000000000222200222222222200000000000000000000000000000",
    "00222222222222222222222220000022222222222220000222222222220002222222222222222222220222202222222222000000000000000000000000000000",
    "00222222222222222222222220000022222222222220000222222222220002222222222222222222222222222222222220000000000000000000000000000000",
    "00222222222222222222222220000022222222222220000222222222220002222222222222222222222222222222222200000000000000000000000000000000",
    "00000000000000000000000000000222222222222220000222222222220002222222222222222222222222222222222000000000000000000000000000000000",
    "00000000000000000000000000000022222222222220000222222222220002222222222222222222222222222222220000000000000000000000000000000000",
    "00000000000000000000000000000222222222222222000222222222220002222222222222222222222222222222200000000000000000000000000000000000",
    "00000000000000000000000000000022222222222222222222222222220002222222222222222222222222222222200000000000000000000000000000000000",
    "00000000000000000000000000000022222222222222222222222222220002222222222222222222222222222222000000000000000000000000000000000000",
    "00000000000000000000000000000022222222222222222222222222220002222222222222222222222222222220000000000000000000000000000000000000",
    "00000000000000000000000000000022222222222222222222222222200002222222222222222222222222222200000000000000000000000000000000000000",
    "00000000000000000000000000000022222222222222222222222222220022222222222222222222200000000000000000000000000000000000000000000000",
    "00000000000000000000000000000022222222222222222222222222222222222222222222222222200000000000000000000000000000000000000000000000",
    "00000000000000000000000000000022222222222222222222222222222222222222222222222222200000000000000000000000000000000000000000000000",
    "00000000000000000000000000000000000000000000000000000222222222222222222222222222200000000000000000000000000000000000000000000000",
    "00000000000000000000000000000000000000000000000000000022222222222222222222222222200000000000000000000000000000000000000000000000",
    "00000000000000000000000000000000000000000000000000000002222222222222222222222222200000000000000000000000000000000000000000000000",
    "00000000000000000000000000000000000000000000000000000002222222222222222222222222200000000000000000000000000000000000000000000000",
    "00000000000000000000000000000000000000000000000000000000222222222222222222222222200000000000000000000000000000000000000000000000",
    "00000000000000000000000000000000000000000000000000000000222222222222222222222222200000000000000000000000000000000000000000000000",
    "00000000000000000000000000000000000000000000000000000000222222222222222222222222200000000000000000000000000000000000000000000000",
    "00000000000000000000000000000000000000000000000000000000222222222222222222222222200000000000000000000000000000000000000000000000",
    "00000000000000000000000000000000000000000000000000000000222222222222222222222222200000000000000000000000000000000000000000000000",
    "00000000000000000000000000000000000000000000000000000000222222222222222222222222200000000000000000000000000000000000000000000000",
    "00000000000000000000000000000000000000000000000000000000222222222222222222222222200000000000000000000000000000000000000000000000",
    "00000000000000000000000000000000000000000000000000000000222222222222222222222222200000000000000000000000000000000000000000000000",
    "00000000000000000000000000000000000000000000000000000002222222222222222222222222200000000000000000000000000000000000000000000000",
    "00000000000000000000000000000000000000000000000000000002222222222222222222222222200000000000000000000000000000000000000000000000",
    "00000000000000000000000000000000000000000000000000000000222222222222222222222222200000000000000000000000000000000000000000000000",
    "00000000000000000000000000000000000000000000000000000000000000000000000000000000000000000000000000000000000000000000000000000000"
  ],
  "agent_spawn_pool": [
    [
      14,
      101
    ],
    [
      100,
      10
    ],
    [
      40,
      40
    ]
  ],
  "npc_spawn_pool": [
    [
      46,
      68
    ],
    [
      81,
      80
    ],
    [
      96,
      30
    ],
    [
      30,
      90
    ]
  ],
  "station_pool": [
    {
      "x": 101,
      "z": 10,
      "dx": 3,
      "dz": 3
    },
    {
      "x": 102,
      "z": 12,
      "dx": 3,
      "dz": 3
    },
    {
      "x": 106,
      "z": 16,
      "dx": 3,
      "dz": 3
    },
    {
      "x": 110,
      "z": 20,
      "dx": 3,
      "dz": 3
    }
  ],
  "max_battery": 200,
  "max_steps": 1000,
  "hero_id": 37,
  "npc_ids": null,
  "local_view_size": 21
}
