{
  "schema_version": 1,
  "map_id": 1,
  "size": [
    128,
    128
  ],
  "custom_map": [
    "00000000000000000000000000000000000000000000000000000000000000000000000000000000000000000000000000000000000000000000000000000000",
    "00000000000000000000000000000000222222222222222222222222222222222222222222222222222222222222222200000000000000000000000000000000",
    "00000000000000000000000000000000222222222222222222222222222222222222222222222222222222222222222200000000000000000000000000000000",
    "00000000000000000000000000000000222222222222222222222222222222222222222222222222222222222222222200000000000000000000000000000000",
    "00000000000000000000000000000000222222222222222222222222222222222222222222222222222222222222222200000000000000000000000000000000",
    "00000000000000000000000000000000222222222222222222222222222222222222222222222222222222222222222200000000000000000000000000000000",
    "00000000000000000000000000000000222222222222222222222222222222222222222222222222222222222222222200000000000000000000000000000000",
    "00000000000000000000000000000000222222222222222222222222222222222222222222222222222222222222222200000000000000000000000000000000",
    "00000000000000000000000000000000222222222222222222222222222222222222222222222222222222222222222200000000000000000000000000000000",
    "00000000000000000000000000000000222222222222222222222222222222222222222222222222222222222222222200000000000000000000000000000000",
    "00000000000000000000000000000000222222222222222222222222222222222222222222222222222222222222222200000000000000000000000000000000",
    "00000000000000000000000000000000222222222222222222222222222222222222222222222222222222222222222200000000000000000000000000000000",
    "00000000000000000000000000000000222222222222222222222222222222222222222222222222222222222222222200000000000000000000000000000000",
    "00000000000000000000000000000000222222222222222222222222222222222222222222222222222222222222222200000000000000000000000000000000",
    "00000000000000000000000000000000222222222222222222222222222222222222222222222222222222222222222200000000000000000000000000000000",
    "00000000000000000000000000000000222222222222222222222222222222222222222222222222222222222222222200000000000000000000000000000000",
    "00000000000000000000000000000000222222222222222222222222222222222222222222222222222222222222222200000000000000000000000000000000",
    "00000000000000000000000000000000222222222222222222222222222222222222222222222222222222222222222200000000000000000000000000000000",
    "00000000000000000000000000000000222222222222222222222222222222222222222222222222222222222222222200000000000000000000000000000000",
    "00000000000000000000000000000000222222222222222222222222222222222222222222222222222222222222222200000000000000000000000000000000",
    "00000000000000000000000000000000222222222222222222222222222222222222222222222222222222222222222200000000000000000000000000000000",
    "00000000000000000000000000000000222222222222222222222222222222222222222222222222222222222222222200000000000000000000000000000000",
    "00000000000000000000000000000000222222222222222222222222222222222222222222222222222222222222222200000000000000000000000000000000",
    "00000000000000000000000000000000222222222222222222222222222222222222222222222222222222222222222200000000000000000000000000000000",
    "00000000000000000000000000000000222222222222222222222222222222222222222222222222222222222222222200000000000000000000000000000000",
    "00000000000000000000000000000000222222222222222222222222222222222222222222222222222222222222222200000000000000000000000000000000",
    "00000000000000000000000000000000222222222222222222222222222222222222222222222222222222222222222200000000000000000000000000000000",
    "00000000000000000000000000000000222222222222222222222222222222222222222222222222222222222222222200000000000000000000000000000000",
    "00000000000000000000000000000000222222222222222222222222222222222222222222222222222222222222222200000000000000000000000000000000",
    "00000000000000000000000000000000222222222222222222222222222222222222222222222222222222222222222200000000000000000000000000000000",
    "00000000000000000000000000000000222222222222222222222222222222222222222222222222222222222222222200000000000000000000000000000000",
    "00000000000000000000000000000000222222222222222222222222222222222222222222222222222222222222222200000000000000000000000000000000",
    "02222222222222222222222222222222222222222222222222222222222222222222222222222222222222222222222222222222222222222222222222222220",
    "02222222222222222222222222222222222222222222222222222222222222222222222222222222222222222222222222222222222222222222222222222220",
    "02222222222222222222222222222222222222222222222222222222222222222222222222222222222222222222222222222222222222222222222222222220",
    "02222222222222222222222222222222222222222222222222222222222222222222222222222222222222222222222222222222222222222222222222222220",
    "02222222222222222222222222222222222222222222222222222222222222222222222222222222222222222222222222222222222222222222222222222220",
    "02222222222222222222222222222222222222222222222222222222222222222222222222222222222222222222222222222222222222222222222222222220",
    "02222222222222222222222222222222222222222222222222222222222222222222222222222222222222222222222222222222222222222222222222222220",
    "02222222222222222222222222222222222222222222222222222222222222222222222222222222222222222222222222222222222222222222222222222220",
    "02222222222222222222222222222222222222222222222222222222222222222222222222222222222222222222222222222222222222222222222222222220",
    "02222222222222222222222222222222222222222222222222222222222222222222222222222222222222222222222222222222222222222222222222222220",
    "02222222222222222222222222222222222222222222222222222222222222222222222222222222222222222222222222222222222222222222222222222220",
    "02222222222222222222222222222222222222222222222222222222222222222222222222222222222222222222222222222222222222222222222222222220",
    "02222222222222222222222222222222222222222222222222222222222222222222222222222222222222222222222222222222222222222222222222222220",
    "02222222222222222222222222222222222222222222222222222222222222222222222222222222222222222222222222222222222222222222222222222220",
    "02222222222222222222222222222222222222222222222222222222222222222222222222222222222222222222222222222222222222222222222222222220",
    "02222222222222222222222222222222222222222222222222222222222222222222222222222222222222222222222222222222222222222222222222222220",
    "02222222222222222222222222222222222222222222222222222222222222222222222222222222222222222222222222222222222222222222222222222220",
    "02222222222222222222222222222222222222222222222222222222222222222222222222222222222222222222222222222222222222222222222222222220",
    "02222222222222222222222222222222222222222222222222222222222222222222222222222222222222222222222222222222222222222222222222222220",
    "02222222222222222222222222222222222222222222222222222222222222222222222222222222222222222222222222222222222222222222222222222220",
    "02222222222222222222222222222222222222222222222222222222222222222222222222222222222222222222222222222222222222222222222222222220",
    "02222222222222222222222222222222222222222222222222222222222222222222222222222222222222222222222222222222222222222222222222222220",
    "02222222222222222222222222222222222222222222222222222222222222222222222222222222222222222222222222222222222222222222222222222220",
    "02222222222222222222222222222222222222222222222222222222222222222222222222222222222222222222222222222222222222222222222222222220",
    "02222222222222222222222222222222222222222222222222222222222222222222222222222222222222222222222222222222222222222222222222222220",
    "02222222222222222222222222222222222222222222222222222222222222222222222222222222222222222222222222222222222222222222222222222220",
    "02222222222222222222222222222222222222222222222222222222222222222222222222222222222222222222222222222222222222222222222222222220",
    "02222222222222222222222222222222222222222222222222222222222222222222222222222222222222222222222222222222222222222222222222222220",
    "02222222222222222222222222222222222222222222222222222222222222222222222222222222222222222222222222222222222222222222222222222220",
    "02222222222222222222222222222222222222222222222222222222222222222222222222222222222222222222222222222222222222222222222222222220",
    "02222222222222222222222222222222222222222222222222222222222222000022222222222222222222222222222222222222222222222222222222222220",
    "02222222222222222222222222222222222222222222222222222222222222000022222222222222222222222222222222222222222222222222222222222220",
    "02222222222222222222222222222222222222222222222222222222222222000022222222222222222222222222222222222222222222222222222222222220",
    "02222222222222222222222222222222222222222222222222222222222222000022222222222222222222222222222222222222222222222222222222222220",
    "02222222222222222222222222222222222222222222222222222222222222222222222222222222222222222222222222222222222222222222222222222220",
    "02222222222222222222222222222222222222222222222222222222222222222222222222222222222222222222222222222222222222222222222222222220",
    "02222222222222222222222222222222222222222222222222222222222222222222222222222222222222222222222222222222222222222222222222222220",
    "02222222222222222222222222222222222222222222222222222222222222222222222222222222222222222222222222222222222222222222222222222220",
    "02222222222222222222222222222222222222222222222222222222222222222222222222222222222222222222222222222222222222222222222222222220",
    "02222222222222222222222222222222222222222222222222222222222222222222222222222222222222222222222222222222222222222222222222222220",
    "02222222222222222222222222222222222222222222222222222222222222222222222222222222222222222222222222222222222222222222222222222220",
    "02222222222222222222222222222222222222222222222222222222222222222222222222222222222222222222222222222222222222222222222222222220",
    "02222222222222222222222222222222222222222222222222222222222222222222222222222222222222222222222222222222222222222222222222222220",
    "02222222222222222222222222222222222222222222222222222222222222222222222222222222222222222222222222222222222222222222222222222220",
    "02222222222222222222222222222222222222222222222222222222222222222222222222222222222222222222222222222222222222222222222222222220",
    "02222222222222222222222222222222222222222222222222222222222222222222222222222222222222222222222222222222222222222222222222222220",
    "02222222222222222222222222222222222222222222222222222222222222222222222222222222222222222222222222222222222222222222222222222220",
    "02222222222222222222222222222222222222222222222222222222222222222222222222222222222222222222222222222222222222222222222222222220",
    "02222222222222222222222222222222222222222222222222222222222222222222222222222222222222222222222222222222222222222222222222222220",
    "02222222222222222222222222222222222222222222222222222222222222222222222222222222222222222222222222222222222222222222222222222220",
    "02222222222222222222222222222222222222222222222222222222222222222222222222222222222222222222222222222222222222222222222222222220",
    "02222222222222222222222222222222222222222222222222222222222222222222222222222222222222222222222222222222222222222222222222222220",
    "02222222222222222222222222222222222222222222222222222222222222222222222222222222222222222222222222222222222222222222222222222220",
    "02222222222222222222222222222222222222222222222222222222222222222222222222222222222222222222222222222222222222222222222222222220",
    "02222222222222222222222222222222222222222222222222222222222222222222222222222222222222222222222222222222222222222222222222222220",
    "02222222222222222222222222222222222222222222222222222222222222222222222222222222222222222222222222222222222222222222222222222220",
    "02222222222222222222222222222222222222222222222222222222222222222222222222222222222222222222222222222222222222222222222222222220",
    "02222222222222222222222222222222222222222222222222222222222222222222222222222222222222222222222222222222222222222222222222222220",
    "02222222222222222222222222222222222222222222222222222222222222222222222222222222222222222222222222222222222222222222222222222220",
    "02222222222222222222222222222222222222222222222222222222222222222222222222222222222222222222222222222222222222222222222222222220",
    "02222222222222222222222222222222222222222222222222222222222222222222222222222222222222222222222222222222222222222222222222222220",
    "02222222222222222222222222222222222222222222222222222222222222222222222222222222222222222222222222222222222222222222222222222220",
    "02222222222222222222222222222222222222222222222222222222222222222222222222222222222222222222222222222222222222222222222222222220",
    "02222222222222222222222222222222222222222222222222222222222222222222222222222222222222222222222222222222222222222222222222222220",
    "00000000000000000000000000000000222222222222222222222222222222222222222222222222222222222222222200000000000000000000000000000000",
    "00000000000000000000000000000000222222222222222222222222222222222222222222222222222222222222222200000000000000000000000000000000",
    "00000000000000000000000000000000222222222222222222222222222222222222222222222222222222222222222200000000000000000000000000000000",
    "00000000000000000000000000000000222222222222222222222222222222222222222222222222222222222222222200000000000000000000000000000000",
    "00000000000000000000000000000000222222222222222222222222222222222222222222222222222222222222222200000000000000000000000000000000",
    "00000000000000000000000000000000222222222222222222222222222222222222222222222222222222222222222200000000000000000000000000000000",
    "00000000000000000000000000000000222222222222222222222222222222222222222222222222222222222222222200000000000000000000000000000000",
    "00000000000000000000000000000000222222222222222222222222222222222222222222222222222222222222222200000000000000000000000000000000",
    "00000000000000000000000000000000222222222222222222222222222222222222222222222222222222222222222200000000000000000000000000000000",
    "00000000000000000000000000000000222222222222222222222222222222222222222222222222222222222222222200000000000000000000000000000000",
    "00000000000000000000000000000000222222222222222222222222222222222222222222222222222222222222222200000000000000000000000000000000",
    "00000000000000000000000000000000222222222222222222222222222222222222222222222222222222222222222200000000000000000000000000000000",
    "00000000000000000000000000000000222222222222222222222222222222222222222222222222222222222222222200000000000000000000000000000000",
    "00000000000000000000000000000000222222222222222222222222222222222222222222222222222222222222222200000000000000000000000000000000",
    "00000000000000000000000000000000222222222222222222222222222222222222222222222222222222222222222200000000000000000000000000000000",
    "00000000000000000000000000000000222222222222222222222222222222222222222222222222222222222222222200000000000000000000000000000000",
    "00000000000000000000000000000000222222222222222222222222222222222222222222222222222222222222222200000000000000000000000000000000",
    "00000000000000000000000000000000222222222222222222222222222222222222222222222222222222222222222200000000000000000000000000000000",
    "00000000000000000000000000000000222222222222222222222222222222222222222222222222222222222222222200000000000000000000000000000000",
    "00000000000000000000000000000000222222222222222222222222222222222222222222222222222222222222222200000000000000000000000000000000",
    "00000000000000000000000000000000222222222222222222222222222222222222222222222222222222222222222200000000000000000000000000000000",
    "00000000000000000000000000000000222222222222222222222222222222222222222222222222222222222222222200000000000000000000000000000000",
    "00000000000000000000000000000000222222222222222222222222222222222222222222222222222222222222222200000000000000000000000000000000",
    "00000000000000000000000000000000222222222222222222222222222222222222222222222222222222222222222200000000000000000000000000000000",
    "00000000000000000000000000000000222222222222222222222222222222222222222222222222222222222222222200000000000000000000000000000000",
    "00000000000000000000000000000000222222222222222222222222222222222222222222222222222222222222222200000000000000000000000000000000",
    "00000000000000000000000000000000222222222222222222222222222222222222222222222222222222222222222200000000000000000000000000000000",
    "00000000000000000000000000000000222222222222222222222222222222222222222222222222222222222222222200000000000000000000000000000000",
    "00000000000000000000000000000000222222222222222222222222222222222222222222222222222222222222222200000000000000000000000000000000",
    "00000000000000000000000000000000222222222222222222222222222222222222222222222222222222222222222200000000000000000000000000000000",
    "00000000000000000000000000000000222222222222222222222222222222222222222222222222222222222222222200000000000000000000000000000000",
    "00000000000000000000000000000000000000000000000000000000000000000000000000000000000000000000000000000000000000000000000000000000"
  ],
  "agent_spawn_pool": [
    [
      12,
      64
    ],
    [
      94,
      4
    ],
    [
      82,
      118
    ]
  ],
  "npc_spawn_pool": [
    [
      64,
      56
    ],
    [
      64,
      72
    ],
    [
      56,
      64
    ],
    [
      72,
      64
    ]
  ],
  "station_pool": [
    {
      "x": 32,
      "z": 10,
      "dx": 3,
      "dz": 3
    },
    {
      "x": 116,
      "z": 32,
      "dx": 3,
      "dz": 3
    },
    {
      "x": 32,
      "z": 116,
      "dx": 3,
      "dz": 3
    },
    {
      "x": 116,
      "z": 93,
      "dx": 3,
      "dz": 3
    }
  ],
  "max_battery": 200,
  "max_steps": 1000,
  "hero_id": 37,
  "npc_ids": null,
  "local_view_size": 21
}
