{
  "schema_version": 1,
  "map_id": 4,
  "size": [128, 128],
  "custom_map": [
    "22222222222222222222222222222222222222222222222222222222222222222222222222222222222222222222222222222222222222222222222222222222",
    "22222222222222222222222222222222222222222222222222222222222222222222222222222222222222222222222222222222222222222222222222222222",
    "22222222222222222222222222222222222222222222222222222222222222222222222222222222222222222222222222222222222222222222222222222222",
    "22222222222222222222222222222222222222222222222222222222222222222222222222222222222222222222222222222222222222222222222222222222",
    "22222222222222222222222222222222222222222222222222222222222222222222222222222222222222222222222222222222222222222222222222222222",
    "22222222222222222222222222222222222222222002222222222222222222222222222222222222222222222222222222222222222222222222222222222222",
    "22222222222222222222222222222222222222222002222222222222222222222222222222222222222222222222222222222222222222222222222222222222",
    "22222222222222222222222222222222222222222222222222222222222222222222222222222222222222222222222222222222222222222222222222222222",
    "22222222222222222222222222222222222222222222222222222222222222222222222222222222222222222222222222222222222222222222222222222222",
    "22222222222222222222222222222222222222222222222222222222222222222222222222222222222222222222222222222222222222222222222222222222",
    "22222222222222222222222222222222222222222222222222222222222222222222222222222222222222222222222222222222222222222222222222222222",
    "22222222222222222222222222222222222222222222222000022222222222222222222222222222222222222222222222222222222222222222222222222222",
    "22222222222222222222222222222222222222222222222000022222222222222222222222222222222222222222222222222222222222222222222222222222",
    "22222222222222222222222222222222222222222222222000022222222222222222222222222222222222222222222222222222222222222222222222222222",
    "22222222222222222222222222222222222222222222222000022222222222222222222222222222222222222222222222222222222222222222222222222222",
    "22222222222222222222222222222222222222222222222222222222222222222222222222222222222222222222222222222222222222222222222222222222",
    "22222222222222222222222222222222222222222222222222222222222222222222222222222222222222222222222222222222222222222222222222222222",
    "22222222222222222222222222222222222222222222222222222222222222200022222222222222222222222222222222222222222222222222222222222222",
    "22222222222222222222222222222222222222222222222222222222222222200022222222222222222222222222222222222222222222222222222222222222",
    "22222222222222222222222222222222222222222222222222222222222222200022222222222222222222222222222222222222222222222222222222222222",
    "22222222222222222222222222222222222222222222222222222222222222222222222222222222222222222222222222222222222222222222222222222222",
    "22222222222222222222222222222222222222222222222222222222222222222222222222222222222222222222222222222222222222222222222222222222",
    "22222222222222222222222222222222222222222222222222222222222222222222222222222222222222222222222222222222222222222222222222222222",
    "22222222222222222222222222222222222222222222222222222222222222222222222222222222222222222222222222222222222222222222222222222222",
    "22222222222222222222222222222222222222222222222222222222222222222222222222222222222222222222222222222222222222222222222222222222",
    "22222222222222222222222222222222222222222222222222222222222222222222222222222222222222222222222222222222222222222222222222222222",
    "22222222222222222222222222222222222222222222222222222222222222222222222222222222222222222222222222222222222222222222222222222222",
    "22222222222222222222222222222222222222222222222222222222222222222222222222222222222222222222222222222222222222222222222222222222",
    "22222222222222222222222222222222222222222222222222222222222222222222222222222222222222222222222222222222222222222222222222222222",
    "22222222222222222222222222222222222222222222222222222222222222222222222222222222222222222222222222222222222222222222222222222222",
    "22222222222222222222222222222222222222222222222222222222222222222222222222222222222222222222222222222222222222222222222222222222",
    "22222222222222222222222222222222222222222222222222222222222222222222222222222222222222222222222222222222222222222222222222222222",
    "22222222222222222222222222222222222222222222222222222222222222222222222222222222222222222222222222222222222222222222222222222222",
    "22222222222222222222222222222222222222222222222222222222222222222222222222222222222222222222222222222222222222222222222222222222",
    "22222222222222222222222222222222222222222222222222222222222222222222222222222222222222222222222222222222222222222222222222222222",
    "22222222222222222222222222222222222222222222222222222222222222222222222222222222222222222222222222222222222222222222222222222222",
    "22222222222222222222222222222222222222222222222222222222222222222222222222222222222222222222222222222222222222222222222222222222",
    "22222222222222222222222222222222222222222222222222222222222222222222222222222222222222222222222222222222222222222222222222222222",
    "22222222222222222222222222222222222222222222222222222222222222222222222222222222222222222222222222222222222222222222222222222222",
    "22222222222222222222222222222222222222222222222222222222222222222222222222222222222222222222222222222222222222222222222222222222",
    "22222222222222222222222222222222222222222222222222222222222222222222222222222222222222222222222222222222222222222222222222222222",
    "22222222222222222222222222222222222222222222222222222222222222222222222222222222222222222222222222222222222222222222222222222222",
    "22222222222222222222222222222222222222222222222222222222222222222222222222220002222222222222222222222222222222222222222222222222",
    "22222222222222222222222222222222222222222222222222222222222222222222222222220002222222222222222222222222222222222222222222222222",
    "22222222222222222222222222222222222222222222222222222222222222222222222222222222222222222222222222222222222222222222222222222222",
    "22222222222222222222222222222222222222222222222222222222222222000022222222222222222222222222222222222222222222222222222222222222",
    "22222222222222222222222222222222222222222222222222222222222222000022222222222222222222222222222222222222222222222222222222222222",
    "22222222222222222222222222222222222222222222222222222222222222000022222222222222222222222222222222222222222222222222222222222222",
    "22222222222222222222222222222222222222222222222222222222222222222222222222222222222222222222222222222222222222222222222222222222",
    "22222222222222222222222222222222222222222222222222222222222222222222222222222222222222222222222222222222222222222222222222222222",
    "22222222222222222222222222222222222222222222222222222222222222222000222222222222222222222222222222222222222222222222222222222222",
    "22222222222222222222222222222222222222222222222222222222222222222000222222222222222222222222222222222222222222222222222222222222",
    "22222222222222222222222222222222222222222222222222222222222222222000222222222222222222222222222222222222222222222222222222222222",
    "22222222222222222222222222222222222222222222222222222222222222222000222222222222222222222222222222222222222222222222222222222222",
    "22222222222222222222222222222222222222222222222222222222222222222222222222222222222222222222222222222222000022222222222222222222",
    "22222222222222222222222222222222222222222222222222222222222222222222222222222222222222222222222222222222000022222222222222222222",
    "22222222222222222222222220002222222222222222222222222222222222222222222222222222222222222222222222222222220022222222222222222222",
    "22222222222222222222222220002222222222222222222222222222222222222222222222222222222222222222222222222222220022222222222222222222",
    "22222222222222222222222220002222222222222222222222222222222222222222222222222222222222222222222222222222220022200222222222222222",
    "22222222222222222222222222222222222222222222222222222222222222222222222222222222222222222222222222222222222222200222222222222222",
    "22222222222222222222222222222222222222222222222222222222222222222222222222222222222222222222222222222222222222200222222222222222",
    "22222222222222222222222222222222222222222222222222222222222222222222222222222220002222222222222222222222222222200222222222222222",
    "22222222222222222222222222222222222222222222222222222222222222222222222222222220002222222222222222222222222222222222222222222222",
    "22222222222222222222222222222222222222222222222222222222222222222222222222222222222222222222222222222222222222222222222222222222",
    "22222222222222222222222222222222222222222222222222222222222222222222222222222222222222222222222222222222222222222222222222222222",
    "22222222222222222222222222222222222222222222222222222222222222222222222222222222222222222222222222222222222222222222222222222222",
    "22222222222222222222222222222222222222222222222222222222222222222222222222222222222222222222222222222222222222222222222222222222",
    "22222222222222222222222222222222222222222222222222222222222222222222222222222222222222222222222222222222222222222222222222222222",
    "22222222222222222222222222222222222222222222222222222222222222222222222222222222222222222222222222222222222222222222222222222222",
    "22222222222222222222222222222222222222222222222222222222222222222222222222222222222222222222222222222222222222222222222222222222",
    "22222222222222222222222222222222222222222222222222222222222222222222222222222222222222222222222222222222222222222222222222222222",
    "22222222222222222222222222222222222222222222222222222222222222222222222222222222222222222222222222222222222222222222222222222222",
    "22222222222222222222222222222222222222222222222222222222222222222222222222222222222222222222222222222222222222222222222222222222",
    "22222222222222222222222222222222222222222222222222222222222222222222222222222222222222222222222222222222222222222222222222222222",
    "22222222222222222222222222222222222222222222222222222222222222222222222222222222222222222222222222222222222222222222222222222222",
    "22222222222222222222222222222222222222222222222222222222222222222222222222222222222222222222222222222222222222002222222222222222",
    "22222222222222222222222222222222222222222222222222222222222222222222222222222222222222222222222222222222222222002222222222222222",
    "22222222222222222222222222222222222222222222222222222222222222222222222222222222222222222222222222222222222222222222222222222222",
    "22222222222222222222222222222222222222222222222222222222222222222222222222222222222222222222222222222222222222222222222222222222",
    "22222222222222222222222222222222222222222222222222222222222222222222222222222222222222222222222222222222222222222222222222222222",
    "22222222222222222222222222222222222222222222222222222222222222222222222222222222222222222222222222222222222222222222222222222222",
    "22222222222222222222222222222222222222222222222222222222222222222222222222222222222222222222222222222222222222222222222222222222",
    "22222222222222222222222222222222222222222222222222222222222222222222222222222222222222222222222222222222222222222222222222222222",
    "22222222222222222222222222222222222222222222222222222222222222222222222222222222222222222222222222222222222222222222222222222222",
    "22222222222222222222222222222222222222222222222222222222222222222222222222222222200022222222222222222222222222222222222222222222",
    "22222222222222222222222222222222222222222222222222222222222222222222222222222222200022222222222222222222222222222222222222222222",
    "22222222222222222222222222222222222222222222222222222222222222222222222222222222200022222222222222222222220000222222222222222222",
    "22222222222222222222222222222222222222222222222222222222222222222222222222222222222222222222222222222222220000222222222222222222",
    "22222222222222222222222222222222222222222222222222222222222222222222222222222222222222222222222222222222220000222222222222222222",
    "22222222222222222222222222222222222222222222222222222222222222222222222222222222222222222222222222222222220000222222222222222222",
    "22222222222222222222222222222222222222222222222222222222222222222222222222222222222222222222222222222222222222222222222222222222",
    "22222222222222222222222222222222222222222222222222222222222222222222222222222200222222222222222222222222222222222222222222222222",
    "22222222222222222222222222222222222222222222222222222222222222222222222222222200222222222222222222222222222222200222222222222222",
    "22222222222200222222222222222222222222222222222222222222222222222222222222222200222222222222222222222222222222200222222222222222",
    "22222222222200222222222222222222222222222222222222222222222222222222222222222200222222222222222222222222222222200222222222222222",
    "22222222222200222222222222222222222222222222222222222222222222222222222222222222222222200002222222222222222222200222222222222222",
    "22222222222222222222222222222222222222222222222222222222222222222222222222222222222222200002222222222222222222222222222222222222",
    "22222222222222222222222222222222222222222222222222222222222222222222222222222222222222200002222222222222222222222222222222222222",
    "22222222222222222222222222222222222222222222222222222222222222222222222222222222222222200002222222222222222222222222222222222222",
    "22222222222222222222222222222222222222222222222222222222222222222222222222222222222222222222222222222222222222222222222222222222",
    "22222222222222222222222222222222222222222222222222222222222222222222222222222222222222222222222222222222222222222222222222222222",
    "22222222222222222222222222222222222222222222222222222222222222222222222222222222222222222222222222222222222222222222222222222222",
    "22222222222222222222222222222222222222222222222222222222222222222222222222222222222222222222222222222222222222222222222222222222",
    "22222222222222222222222222222222222222222222222222222222222222222222222222222222222222222222222222222222222222222222222222222222",
    "22222222222222222222222222222222222222222222222222222222222222222222222222222222222222222222222222222222222222222222222222222222",
    "22222222222222222222222222222222222222222222222222222222222222222222222222222222222222222222222222222222222222222222222222222222",
    "22222222222222222222222222222222222222222222222222222222222222222222222222222222222222222222222222222222222222222222222222222222",
    "22222222222222222222222222222222222222222222222222222222222222222222222222222222222222222222222222222222222222222222222222222222",
    "22222222222222222222222222222222222222222222222222222222222222222222222222222222222222222222222222222222222222222222222222222222",
    "22222222222222222222222222222222222222222222222222222222222222222222222222222222222222222222222222222222222222222222222222222222",
    "22222222222222222222222222222222222222222222222222222222222222222222222222222222222222222222222222222222222222222222222222222222",
    "22222222222222222222222222222222222222222222222222222222222222222222222222222222222222222222222222222222222222222222222222222222",
    "22222222222222222222222222222222222222222222222222222222222222222222222222222222222222222222222222222222222222222222222222222222",
    "22222222222222222222222222222222222222222222222222222222222222222222222222222222222222222222222222222222222222222222222222222222",
    "22222222222222222222222222222222222222222222222222222222222222222222222222222222222222222222222222222222222222222222222222222222",
    "22222222222222222222222222222222222222222222222222222222222222222222222222222222222222222222222222222222222222222222222222222222",
    "22222222222222222222222222222222222222222222222222222222222222222222222222222222222222222222222222222222222222222222222222222222",
    "22222222222222222222222222222222222222222222222222222222222222222222222222222222222222222222222222222222222222222222222222222222",
    "22222222222222222222222222222222222222222222222222222222222222222222222222222222222222222222222222222222222222222222222222222222",
    "22222222222222222222222222222222222222222222222222222222222222222222222222222222222222222222222222222222222222222222222222222222",
    "22222222222222222222222222222222222222222222222222222222222222222222222222222222222222222222222222222222222222222222222222222222",
    "22222222222222222222222222222222222222222222222222222222222222222222222222222222222222222222222222222222222222222222222222222222",
    "22222222222222222222222222222222222222222222222222222222222222222222222222222222222222222222222222222222222222222222222222222222",
    "22222222222222222222222222222222222222222222222222222222222222222222222222222222222222222222222222222222222222222222222222222222",
    "22222222222222222222222222222222222222222222222222222222222222222222222222222222222222222222222222222222222222222222222222222222",
    "22222222222222222222222222222222222222222222222222222222222222222222222222222222222222222222222222222222222222222222222222222222",
    "22222222222222222222222222222222222222222222222222222222222222222222222222222222222222222222222222222222222222222222222222222222",
    "22222222222222222222222222222222222222222222222222222222222222222222222222222222222222222222222222222222222222222222222222222222"
  ],
  "agent_spawn_pool": [
    [2, 64],
    [125, 64],
    [64, 2],
    [64, 125]
  ],
  "npc_spawn_pool": [
    [10, 10],
    [10, 117],
    [117, 10],
    [117, 117],
    [64, 64]
  ],
  "station_pool": [{"x": 2, "z": 2, "dx": 3, "dz": 3}, {"x": 123, "z": 2, "dx": 3, "dz": 3}, {"x": 2, "z": 123, "dx": 3, "dz": 3}, {"x": 123, "z": 123, "dx": 3, "dz": 3}],
  "max_battery": 200,
  "max_steps": 1000,
  "hero_id": 37,
  "npc_ids": null,
  "local_view_size": 21
}
