{
  "schema_version": 1,
  "map_id": 1,
  "size": [128, 128],
  "custom_map": [
    "00000000000000000000000000000000000000000000000000000000000000000000000000000000000000000000000000000000000000000000000000000000",
    "00000000000000000000000000000000222222222222222222222222222222222222222222222222222222222222222200000000000000000000000000000000",
    "00000000000000000000000000000000222222222222222222222222222222222222222222222222222222222222222200000000000000000000000000000000",
    "00000000000000000000000000000000222222222222222222222222222222222222222222222222222222222222222200000000000000000000000000000000",
    "00000000000000000000000000000000222222222222222222222222222222222222222222222222222222222222222200000000000000000000000000000000",
    "00000000000000000000000000000000222222222222222222222222222222222222222222222222222222222222222200000000000000000000000000000000",
    "00000000000000000000000000000000222222222222222222222222222222222222222222222222222222222222222200000000000000000000000000000000",
    "00000000000000000000000000000000222222222222222222222222222222222222222222222222222222222222222200000000000000000000000000000000",
    "00000000000000000000000000000000222222222222222222222222222222222222222222222222222222222222222200000000000000000000000000000000",
    "00000000000000000000000000000000222222222222222222222222222222222222222222222222222222222222222200000000000000000000000000000000",
    "00000000000000000000000000000000222222222222222222222222222222222222222222222222222222222222222200000000000000000000000000000000",
    "00000000000000000000000000000000222222222222222222222222222222222222222222222222222222222222222200000000000000000000000000000000",
    "00000000000000000000000000000000222222222222222222222222222222222222222222222222222222222222222200000000000000000000000000000000",
    "00000000000000000000000000000000222222222222222222222222222222222222222222222222222222222222222200000000000000000000000000000000",
    "00000000000000000000000000000000222222222222222222222222222222222222222222222222222222222222222200000000000000000000000000000000",
    "00000000000000000000000000000000222222222222222222222222222222222222222222222222222222222222222200000000000000000000000000000000",
    "00000000000000000000000000000000222222222222222222222222222222222222222222222222222222222222222200000000000000000000000000000000",
    "00000000000000000000000000000000222222222222222222222222222222222222222222222222222222222222222200000000000000000000000000000000",
    "00000000000000000000000000000000222222222222222222222222222222222222222222222222222222222222222200000000000000000000000000000000",
    "00000000000000000000000000000000222222222222222222222222222222222222222222222222222222222222222200000000000000000000000000000000",
    "00000000000000000000000000000000222222222222222222222222222222222222222222222222222222222222222200000000000000000000000000000000",
    "00000000000000000000000000000000222222222222222222222222222222222222222222222222222222222222222200000000000000000000000000000000",
    "00000000000000000000000000000000222222222222222222222222222222222222222222222222222222222222222200000000000000000000000000000000",
    "00000000000000000000000000000000222222222222222222222222222222222222222222222222222222222222222200000000000000000000000000000000",
    "00000000000000000000000000000000222222222222222222222222222222222222222222222222222222222222222200000000000000000000000000000000",
    "00000000000000000000000000000000222222222222222222222222222222222222222222222222222222222222222200000000000000000000000000000000",
    "00000000000000000000000000000000222222222222222222222222222222222222222222222222222222222222222200000000000000000000000000000000",
    "00000000000000000000000000000000222222222222222222222222222222222222222222222222222222222222222200000000000000000000000000000000",
    "00000000000000000000000000000000222222222222222222222222222222222222222222222222222222222222222200000000000000000000000000000000",
    "00000000000000000000000000000000222222222222222222222222222222222222222222222222222222222222222200000000000000000000000000000000",
    "00000000000000000000000000000000222222222222222222222222222222222222222222222222222222222222222200000000000000000000000000000000",
    "00000000000000000000000000000000222222222222222222222222222222222222222222222222222222222222222200000000000000000000000000000000",
    "02222222222222222222222222222222222222222222222222222222222222222222222222222222222222222222222222222222222222222222222222222220",
    "02222222222222222222222222222222222222222222222222222222222222222222222222222222222222222222222222222222222222222222222222222220",
    "02222222222222222222222222222222222222222222222222222222222222222222222222222222222222222222222222222222222222222222222222222220",
    "02222222222222222222222222222222222222222222222222222222222222222222222222222222222222222222222222222222222222222222222222222220",
    "02222222222222222222222222222222222222222222222222222222222222222222222222222222222222222222222222222222222222222222222222222220",
    "02222222222222222222222222222222222222222222222222222222222222222222222222222222222222222222222222222222222222222222222222222220",
    "02222222222222222222222222222222222222222222222222222222222222222222222222222222222222222222222222222222222222222222222222222220",
    "02222222222222222222222222222222222222222222222222222222222222222222222222222222222222222222222222222222222222222222222222222220",
    "02222222222222222222222222222222222222222222222222222222222222222222222222222222222222222222222222222222222222222222222222222220",
    "02222222222222222222222222222222222222222222222222222222222222222222222222222222222222222222222222222222222222222222222222222220",
    "02222222222222222222222222222222222222222222222222222222222222222222222222222222222222222222222222222222222222222222222222222220",
    "02222222222222222222222222222222222222222222222222222222222222222222222222222222222222222222222222222222222222222222222222222220",
    "02222222222222222222222222222222222222222222222222222222222222222222222222222222222222222222222222222222222222222222222222222220",
    "02222222222222222222222222222222222222222222222222222222222222222222222222222222222222222222222222222222222222222222222222222220",
    "02222222222222222222222222222222222222222222222222222222222222222222222222222222222222222222222222222222222222222222222222222220",
    "02222222222222222222222222222222222222222222222222222222222222222222222222222222222222222222222222222222222222222222222222222220",
    "02222222222222222222222222222222222222222222222222222222222222222222222222222222222222222222222222222222222222222222222222222220",
    "02222222222222222222222222222222222222222222222222222222222222222222222222222222222222222222222222222222222222222222222222222220",
    "02222222222222222222222222222222222222222222222222222222222222222222222222222222222222222222222222222222222222222222222222222220",
    "02222222222222222222222222222222222222222222222222222222222222222222222222222222222222222222222222222222222222222222222222222220",
    "02222222222222222222222222222222222222222222222222222222222222222222222222222222222222222222222222222222222222222222222222222220",
    "02222222222222222222222222222222222222222222222222222222222222222222222222222222222222222222222222222222222222222222222222222220",
    "02222222222222222222222222222222222222222222222222222222222222222222222222222222222222222222222222222222222222222222222222222220",
    "02222222222222222222222222222222222222222222222222222222222222222222222222222222222222222222222222222222222222222222222222222220",
    "02222222222222222222222222222222222222222222222222222222000000000000000022222222222222222222222222222222222222222222222222222220",
    "02222222222222222222222222222222222222222222222222222222000000000000000022222222222222222222222222222222222222222222222222222220",
    "02222222222222222222222222222222222222222222222222222222000000000000000022222222222222222222222222222222222222222222222222222220",
    "02222222222222222222222222222222222222222222222222222222000000000000000022222222222222222222222222222222222222222222222222222220",
    "02222222222222222222222222222222222222222222222222222222000000000000000022222222222222222222222222222222222222222222222222222220",
    "02222222222222222222222222222222222222222222222222222222000000000000000022222222222222222222222222222222222222222222222222222220",
    "02222222222222222222222222222222222222222222222222222222000000000000000022222222222222222222222222222222222222222222222222222220",
    "02222222222222222222222222222222222222222222222222222222000000000000000022222222222222222222222222222222222222222222222222222220",
    "02222222222222222222222222222222222222222222222222222222000000000000000022222222222222222222222222222222222222222222222222222220",
    "02222222222222222222222222222222222222222222222222222222000000000000000022222222222222222222222222222222222222222222222222222220",
    "02222222222222222222222222222222222222222222222222222222000000000000000022222222222222222222222222222222222222222222222222222220",
    "02222222222222222222222222222222222222222222222222222222000000000000000022222222222222222222222222222222222222222222222222222220",
    "02222222222222222222222222222222222222222222222222222222000000000000000022222222222222222222222222222222222222222222222222222220",
    "02222222222222222222222222222222222222222222222222222222000000000000000022222222222222222222222222222222222222222222222222222220",
    "02222222222222222222222222222222222222222222222222222222000000000000000022222222222222222222222222222222222222222222222222222220",
    "02222222222222222222222222222222222222222222222222222222000000000000000022222222222222222222222222222222222222222222222222222220",
    "02222222222222222222222222222222222222222222222222222222222222222222222222222222222222222222222222222222222222222222222222222220",
    "02222222222222222222222222222222222222222222222222222222222222222222222222222222222222222222222222222222222222222222222222222220",
    "02222222222222222222222222222222222222222222222222222222222222222222222222222222222222222222222222222222222222222222222222222220",
    "02222222222222222222222222222222222222222222222222222222222222222222222222222222222222222222222222222222222222222222222222222220",
    "02222222222222222222222222222222222222222222222222222222222222222222222222222222222222222222222222222222222222222222222222222220",
    "02222222222222222222222222222222222222222222222222222222222222222222222222222222222222222222222222222222222222222222222222222220",
    "02222222222222222222222222222222222222222222222222222222222222222222222222222222222222222222222222222222222222222222222222222220",
    "02222222222222222222222222222222222222222222222222222222222222222222222222222222222222222222222222222222222222222222222222222220",
    "02222222222222222222222222222222222222222222222222222222222222222222222222222222222222222222222222222222222222222222222222222220",
    "02222222222222222222222222222222222222222222222222222222222222222222222222222222222222222222222222222222222222222222222222222220",
    "02222222222222222222222222222222222222222222222222222222222222222222222222222222222222222222222222222222222222222222222222222220",
    "02222222222222222222222222222222222222222222222222222222222222222222222222222222222222222222222222222222222222222222222222222220",
    "02222222222222222222222222222222222222222222222222222222222222222222222222222222222222222222222222222222222222222222222222222220",
    "02222222222222222222222222222222222222222222222222222222222222222222222222222222222222222222222222222222222222222222222222222220",
    "02222222222222222222222222222222222222222222222222222222222222222222222222222222222222222222222222222222222222222222222222222220",
    "02222222222222222222222222222222222222222222222222222222222222222222222222222222222222222222222222222222222222222222222222222220",
    "02222222222222222222222222222222222222222222222222222222222222222222222222222222222222222222222222222222222222222222222222222220",
    "02222222222222222222222222222222222222222222222222222222222222222222222222222222222222222222222222222222222222222222222222222220",
    "02222222222222222222222222222222222222222222222222222222222222222222222222222222222222222222222222222222222222222222222222222220",
    "02222222222222222222222222222222222222222222222222222222222222222222222222222222222222222222222222222222222222222222222222222220",
    "02222222222222222222222222222222222222222222222222222222222222222222222222222222222222222222222222222222222222222222222222222220",
    "02222222222222222222222222222222222222222222222222222222222222222222222222222222222222222222222222222222222222222222222222222220",
    "02222222222222222222222222222222222222222222222222222222222222222222222222222222222222222222222222222222222222222222222222222220",
    "02222222222222222222222222222222222222222222222222222222222222222222222222222222222222222222222222222222222222222222222222222220",
    "00000000000000000000000000000000222222222222222222222222222222222222222222222222222222222222222200000000000000000000000000000000",
    "00000000000000000000000000000000222222222222222222222222222222222222222222222222222222222222222200000000000000000000000000000000",
    "00000000000000000000000000000000222222222222222222222222222222222222222222222222222222222222222200000000000000000000000000000000",
    "00000000000000000000000000000000222222222222222222222222222222222222222222222222222222222222222200000000000000000000000000000000",
    "00000000000000000000000000000000222222222222222222222222222222222222222222222222222222222222222200000000000000000000000000000000",
    "00000000000000000000000000000000222222222222222222222222222222222222222222222222222222222222222200000000000000000000000000000000",
    "00000000000000000000000000000000222222222222222222222222222222222222222222222222222222222222222200000000000000000000000000000000",
    "00000000000000000000000000000000222222222222222222222222222222222222222222222222222222222222222200000000000000000000000000000000",
    "00000000000000000000000000000000222222222222222222222222222222222222222222222222222222222222222200000000000000000000000000000000",
    "00000000000000000000000000000000222222222222222222222222222222222222222222222222222222222222222200000000000000000000000000000000",
    "00000000000000000000000000000000222222222222222222222222222222222222222222222222222222222222222200000000000000000000000000000000",
    "00000000000000000000000000000000222222222222222222222222222222222222222222222222222222222222222200000000000000000000000000000000",
    "00000000000000000000000000000000222222222222222222222222222222222222222222222222222222222222222200000000000000000000000000000000",
    "00000000000000000000000000000000222222222222222222222222222222222222222222222222222222222222222200000000000000000000000000000000",
    "00000000000000000000000000000000222222222222222222222222222222222222222222222222222222222222222200000000000000000000000000000000",
    "00000000000000000000000000000000222222222222222222222222222222222222222222222222222222222222222200000000000000000000000000000000",
    "00000000000000000000000000000000222222222222222222222222222222222222222222222222222222222222222200000000000000000000000000000000",
    "00000000000000000000000000000000222222222222222222222222222222222222222222222222222222222222222200000000000000000000000000000000",
    "00000000000000000000000000000000222222222222222222222222222222222222222222222222222222222222222200000000000000000000000000000000",
    "00000000000000000000000000000000222222222222222222222222222222222222222222222222222222222222222200000000000000000000000000000000",
    "00000000000000000000000000000000222222222222222222222222222222222222222222222222222222222222222200000000000000000000000000000000",
    "00000000000000000000000000000000222222222222222222222222222222222222222222222222222222222222222200000000000000000000000000000000",
    "00000000000000000000000000000000222222222222222222222222222222222222222222222222222222222222222200000000000000000000000000000000",
    "00000000000000000000000000000000222222222222222222222222222222222222222222222222222222222222222200000000000000000000000000000000",
    "00000000000000000000000000000000222222222222222222222222222222222222222222222222222222222222222200000000000000000000000000000000",
    "00000000000000000000000000000000222222222222222222222222222222222222222222222222222222222222222200000000000000000000000000000000",
    "00000000000000000000000000000000222222222222222222222222222222222222222222222222222222222222222200000000000000000000000000000000",
    "00000000000000000000000000000000222222222222222222222222222222222222222222222222222222222222222200000000000000000000000000000000",
    "00000000000000000000000000000000222222222222222222222222222222222222222222222222222222222222222200000000000000000000000000000000",
    "00000000000000000000000000000000222222222222222222222222222222222222222222222222222222222222222200000000000000000000000000000000",
    "00000000000000000000000000000000222222222222222222222222222222222222222222222222222222222222222200000000000000000000000000000000",
    "00000000000000000000000000000000000000000000000000000000000000000000000000000000000000000000000000000000000000000000000000000000"
  ],
  "agent_spawn_pool": [
    [64, 1],
    [64, 126],
    [1, 64],
    [126, 64]
  ],
  "npc_spawn_pool": [
    [33, 33],
    [95, 33],
    [33, 95],
    [95, 95]
  ],
  "station_pool": [{"x": 62, "z": 8, "dx": 3, "dz": 3}, {"x": 62, "z": 118, "dx": 3, "dz": 3}, {"x": 8, "z": 62, "dx": 3, "dz": 3}, {"x": 118, "z": 62, "dx": 3, "dz": 3}],
  "max_battery": 200,
  "max_steps": 1000,
  "hero_id": 37,
  "npc_ids": null,
  "local_view_size": 21
}
