{
  "schema_version": 1,
  "map_id": 2,
  "size": [128, 128],
  "custom_map": [
    "00000000000000000000000000000000000000000000000000000000000000000000000000000000000000000000000000000000000000000000000000000000",
    "02222222222222222222222222222222222222222222222222222222222222222222222222222222222222222222222222222222222222222222222222222220",
    "02222222222222222222222222222222222222222222222222222222222222222222222222222222222222222222222222222222222222222222222222222220",
    "02222222222222222222222222222222222222222222222222222222222222222222222222222222222222222222222222222222222222222222222222222220",
    "02222222222222222222222222222222222222222222222222222222222222222222222222222222222222222222222222222222222222222222222222222220",
    "02222222222222222222222222222222222222222222222222222222222222222222222222222222222222222222222222222222222222222222222222222220",
    "02222222222222222222222222222222222222222222222222222222222222222222222222222222222222222222222222222222222222222222222222222220",
    "02222222222222222222222222222222222222222222222222222222222222222222222222222222222222222222222222222222222222222222222222222220",
    "02222222222222222222222222222222222222222222222222222222222222222222222222222222222222222222222222222222222222222222222222222220",
    "02222222222222222222222222222222222222222222222222222222222222222222222222222222222222222222222222222222222222222222222222222220",
    "02222222222222222222222222222222222222222222222222222222222222222222222222222222222222222222222222222222222222222222222222222220",
    "02222222222222222222222222222222222222222222222222222222222222222222222222222222222222222222222222222222222222222222222222222220",
    "02222222222222222222222222222222222222222222222222222222222222222222222222222222222222222222222222222222222222222222222222222220",
    "02222222222222222222222222222222222222222222222222222222222222222222222222222222222222222222222222222222222222222222222222222220",
    "02222222222222222222222222222222222222222222222222222222222222222222222222222222222222222222222222222222222222222222222222222220",
    "02222222222222222222222222222222222222222222222200000022222222222222222222200000222222222222222222222222222222222222222222222220",
    "02222222222222222222222222222222222222222222222200000022222222222222222222000000222222222222222222222222222222222222222222222220",
    "02222222222222222222222222222222222222222222222200000022222222222222222222000000222222222222222222222222222222222222222222222220",
    "02222222222222222222222222222222222222222222222200000022222222222222222222000000222222222222222222222222222222222222222222222220",
    "02222222222222222222222222222222222222222222222200000022222222222222222222000000222222222222222222222222222222222222222222222220",
    "02222222222222222222222222222222222222222222222200000022222222222222222222000000222222222222222222222222222222222222222222222220",
    "02222222222222222222000000000022222222222222222200000022222222222222222222000000222222222222222222222222222222222222222222222220",
    "02222222222222222222000000000022222222222222222200000022222222222222222222000000222222222222222222222222222222222222222222222220",
    "02222222222222222222000000000022222222222222222200000022222222222222222222000000222222222222222222222222222222222222222222222220",
    "02222222222222222222000000000022222222222222222200000022222222222222222222000000222222222222222222222222222222222222222222222220",
    "02222222222222222222000000000022222222222222222200000022222222222222222222000000222222222222222222222222222222222222222222222220",
    "02222222222222222222000000000022222222222222222200000022222222222222222222000000222222222222222222222222222222222222222222222220",
    "02222222222222222222000000000022222222222222222200000022222222222222222222000000222222222222222222222222222222222222222222222220",
    "02222222222222222222000000000022222222222222222200000022222222222222222222000000222222222222222222222222222222222222222222222220",
    "02222222222222222222000000000022222222222222222200000022222222222222222222000000222222222222222222222222222222222222222222222220",
    "02222222222222222222222222222222222222222222222200000022222222222222222222000000222222222222222222222222222222222222222222222220",
    "02222222222222222222222222222222222222222222222200000022222222222222222222000000222222222222222222222222222222222222222222222220",
    "02222222222222222222222222222222222222222222222200000022222222222222222222000000222222222222222222222222222222222222222222222220",
    "02222222222222222222222222222222222222222222222200000022222222222222222222000000222222222222222222222222222222222222222222222220",
    "02222222222222222222222222222222222222222222222200000022222222222222222222000000222222222222222222222222222222222222222222222220",
    "02222222222222222222222222222222222222222222222200000022222222222222222222000000222222222222222222222222222222222222222222222220",
    "02222222222222222222222222222222222222222222222200000022222222222222222222000000222222222222222222222222222222222222222222222220",
    "02222222222222222222222222222222222222222222222200000022222222222222222222000000222222222222222222222222222222222222222222222220",
    "02222222222222222222222222222222222222222222222200000022222222222222222222000000222222222222222222222222222222222222222222222220",
    "02222222222222222222222222222222222222222222222200000022222222222222222222000000222222222222222222222222222222222222222222222220",
    "02222222222222222222222222222222222222222222222200000022222222222222222222000000222222222222222222222222222222222222222222222220",
    "02222222222222222222222222222222222222222222222200000022222222222222222222000000222222222222222222222222222222222222222222222220",
    "02222222222222222222222222222222222222222222222222222222222222222222222222222222222222222222222222222222222222222222222222222220",
    "02222222222222222222222222222222222222222222222222222222222222222222222222222222222222222222222222222222222222222222222222222220",
    "02222222222222222222222222222222222222222222222222222222222222222222222222222222222222222222222222222222222222222222222222222220",
    "02222222222222222222222222222222222222222222222222222222222222222222222222222222222222222222222222222222222222222222222222222220",
    "02222222222222222222222222222222222222222222222222222222222222222222222222222222222222222222222222222222222222222222222222222220",
    "02222222222222222222222222222222222222222222222222222222222222222222222222222222222222222222222222222222222222222222222222222220",
    "02222222222222220000000000000000000000000022222222222222222200000000022222222222222222000000000000000000000000000222222222222220",
    "02222222222222220000000000000000000000000022222222222222222200000000022222222222222222000000000000000000000000000222222222222220",
    "02222222222222220000000000000000000000000022222222222222222200000000022222222222222222000000000000000000000000000222222222222220",
    "02222222222222220000000000000000000000000022222222222222222200000000022222222222222222000000000000000000000000000222222222222220",
    "02222222222222220000000000000000000000000022222222222222222200000000022222222222222222000000000000000000000000000222222222222220",
    "02222222222222220000000000000000000000000022222222222222222200000000022222222222222222000000000000000000000000000222222222222220",
    "02222222222222222222222222222222222222222222222222222222222222222222222222222222222222222222222222222222222222222222222222222220",
    "02222222222222222222222222222222222222222222222222222222222222222222222222222222222222222222222222222222222222222222222222222220",
    "02222222222222222222222222222222222222222222222222222222222222222222222222222222222222222222222222222222222222222222222222222220",
    "02222222222222222222222222222222222222222222222222222222222222222222222222222222222222222222222222222222222222222222222222222220",
    "02222222222222222222222222222222222222222222222222222222222222222222222222222222222222222222222222222222222222222222222222222220",
    "02222222222222222222222222222222222222222222222222222222222222222222222222222222222222222222222222222222222222222222222222222220",
    "02222222222222222222222222222222222222222222222200000022222222222222222222000000222222222222222222222222222222222222222222222220",
    "02222222222222222222222222222222222222222222222200000022222222222222222222000000222222222222222222222222222222222222222222222220",
    "02222222222222222222222222222222222222222222222200000022222222222222222222000000222222222222222222222222222222222222222222222220",
    "02222222222222222222222222222222222222222222222200000022222222222222222222000000222222222222222222222222222222222222222222222220",
    "02222222222222222222222222222222222222222222222200000022222222222222222222000000222222222222222222222222222222222222222222222220",
    "02222222222222222222222222222222222222222222222200000022222222222222222222000000222222222222222222222222222222222222222222222220",
    "02222222222222222222222222222222222222222222222200000022222222222222222222000000222222222222222222222222222222222222222222222220",
    "02222222222222222222222222222222222222222222222200000022222222222222222222000000222222222222222222222222222222222222222222222220",
    "02222222222222222222222222222222222222222222222200000022222222222222222222000000222222222222222222222222222222222222222222222220",
    "02222222222222222222222222222222222222222222222222222222222222222222222222222222222222222222222222222222222222222222222222222220",
    "02222222222222222222222222222222222222222222222222222222222222222222222222222222222222222222222222222222222222222222222222222220",
    "02222222222222222222222222222222222222222222222222222222222222222222222222222222222222222222222222222222222222222222222222222220",
    "02222222222222222222222222222222222222222222222222222222222222222222222222222222222222222222222222222222222222222222222222222220",
    "02222222222222222222222222222222222222222222222222222222222222222222222222222222222222222222222222222222222222222222222222222220",
    "02222222222222220000000000000000000000000022222222222222222200000000022222222222222222000000000000000000000000000222222222222220",
    "02222222222222220000000000000000000000000022222222222222222200000000022222222222222222000000000000000000000000000222222222222220",
    "02222222222222220000000000000000000000000022222222222222222200000000022222222222222222000000000000000000000000000222222222222220",
    "02222222222222220000000000000000000000000022222222222222222200000000022222222222222222000000000000000000000000000222222222222220",
    "02222222222222220000000000000000000000000022222222222222222200000000022222222222222222000000000000000000000000000222222222222220",
    "02222222222222220000000000000000000000000022222222222222222200000000022222222222222222000000000000000000000000000222222222222220",
    "02222222222222222222222222222222222222222222222222222222222222222222222222222222222222222222222222222222222222222222222222222220",
    "02222222222222222222222222222222222222222222222222222222222222222222222222222222222222222222222222222222222222222222222222222220",
    "02222222222222222222222222222222222222222222222222222222222222222222222222222222222222222222222222222222222222222222222222222220",
    "02222222222222222222222222222222222222222222222222222222222222222222222222222222222222222222222222222222222222222222222222222220",
    "02222222222222222222222222222222222222222222222222222222222222222222222222222222222222222222222222222222222222222222222222222220",
    "02222222222222222222222222222222222222222222222222222222222222222222222222222222222222222222222222222222222222222222222222222220",
    "02222222222222222222222222222222222222222222222200000022222222222222222222000000222222222222222222222222222222222222222222222220",
    "02222222222222222222222222222222222222222222222200000022222222222222222222000000222222222222222222222222222222222222222222222220",
    "02222222222222222222222222222222222222222222222200000022222222222222222222000000222222222222222222222222222222222222222222222220",
    "02222222222222222222222222222222222222222222222200000022222222222222222222000000222222222222222222222222222222222222222222222220",
    "02222222222222222222222222222222222222222222222200000022222222222222222222000000222222222222222222222222222222222222222222222220",
    "02222222222222222222222222222222222222222222222200000022222222222222222222000000222222222222222222222222222222222222222222222220",
    "02222222222222222222222222222222222222222222222200000022222222222222222222000000222222222222222222222222222222222222222222222220",
    "02222222222222222222222222222222222222222222222200000022222222222222222222000000222222222222222222222222222222222222222222222220",
    "02222222222222222222222222222222222222222222222200000022222222222222222222000000222222222222222222222222222222222222222222222220",
    "02222222222222222222222222222222222222222222222200000022222222222222222222000000222222222222222222222222222222222222222222222220",
    "02222222222222222222222222222222222222222222222200000022222222222222222222000000222222222222222222222222222222222222222222222220",
    "02222222222222222222222222222222222222222222222200000022222222222222222222000000222222222222222222222222222222222222222222222220",
    "02222222222222222222222222222222222222222222222200000022222222222222222222000000222222222222222222000000000022222222222222222220",
    "02222222222222222222222222222222222222222222222200000022222222222222222222000000222222222222222222000000000022222222222222222220",
    "02222222222222222222222222222222222222222222222200000022222222222222222222000000222222222222222222000000000022222222222222222220",
    "02222222222222222222222222222222222222222222222200000022222222222222222222000000222222222222222222000000000022222222222222222220",
    "02222222222222222222222222222222222222222222222200000022222222222222222222000000222222222222222222000000000022222222222222222220",
    "02222222222222222222222222222222222222222222222200000022222222222222222222000000222222222222222222000000000022222222222222222220",
    "02222222222222222222222222222222222222222222222200000022222222222222222222000000222222222222222222000000000022222222222222222220",
    "02222222222222222222222222222222222222222222222200000022222222222222222222000000222222222222222222000000000022222222222222222220",
    "02222222222222222222222222222222222222222222222200000022222222222222222222000000222222222222222222000000000022222222222222222220",
    "02222222222222222222222222222222222222222222222200000022222222222222222222000000222222222222222222000000000022222222222222222220",
    "02222222222222222222222222222222222222222222222200000022222222222222222222000000222222222222222222222222222222222222222222222220",
    "02222222222222222222222222222222222222222222222200000022222222222222222222000000222222222222222222222222222222222222222222222220",
    "02222222222222222222222222222222222222222222222200000022222222222222222222000000222222222222222222222222222222222222222222222220",
    "02222222222222222222222222222222222222222222222200000022222222222222222222000000222222222222222222222222222222222222222222222220",
    "02222222222222222222222222222222222222222222222200000022222222222222222222000000222222222222222222222222222222222222222222222220",
    "02222222222222222222222222222222222222222222222222222222222222222222222222222222222222222222222222222222222222222222222222222220",
    "02222222222222222222222222222222222222222222222222222222222222222222222222222222222222222222222222222222222222222222222222222220",
    "02222222222222222222222222222222222222222222222222222222222222222222222222222222222222222222222222222222222222222222222222222220",
    "02222222222222222222222222222222222222222222222222222222222222222222222222222222222222222222222222222222222222222222222222222220",
    "02222222222222222222222222222222222222222222222222222222222222222222222222222222222222222222222222222222222222222222222222222220",
    "02222222222222222222222222222222222222222222222222222222222222222222222222222222222222222222222222222222222222222222222222222220",
    "02222222222222222222222222222222222222222222222222222222222222222222222222222222222222222222222222222222222222222222222222222220",
    "02222222222222222222222222222222222222222222222222222222222222222222222222222222222222222222222222222222222222222222222222222220",
    "02222222222222222222222222222222222222222222222222222222222222222222222222222222222222222222222222222222222222222222222222222220",
    "02222222222222222222222222222222222222222222222222222222222222222222222222222222222222222222222222222222222222222222222222222220",
    "02222222222222222222222222222222222222222222222222222222222222222222222222222222222222222222222222222222222222222222222222222220",
    "02222222222222222222222222222222222222222222222222222222222222222222222222222222222222222222222222222222222222222222222222222220",
    "02222222222222222222222222222222222222222222222222222222222222222222222222222222222222222222222222222222222222222222222222222220",
    "02222222222222222222222222222222222222222222222222222222222222222222222222222222222222222222222222222222222222222222222222222220",
    "00000000000000000000000000000000000000000000000000000000000000000000000000000000000000000000000000000000000000000000000000000000"
  ],
  "agent_spawn_pool": [
    [40, 38],
    [86, 38],
    [40, 90],
    [86, 90]
  ],
  "npc_spawn_pool": [
    [11, 11],
    [10, 64],
    [117, 64],
    [117, 114]
  ],
  "station_pool": [{"x": 5, "z": 5, "dx": 3, "dz": 3}, {"x": 101, "z": 27, "dx": 3, "dz": 3}, {"x": 63, "z": 63, "dx": 3, "dz": 3}, {"x": 29, "z": 98, "dx": 3, "dz": 3}],
  "max_battery": 200,
  "max_steps": 1000,
  "hero_id": 37,
  "npc_ids": null,
  "local_view_size": 21
}
