{
  "schema_version": 1,
  "map_id": 9,
  "size": [128, 128],
  "custom_map": [
    "00000000000000000000000000000000000000000000000000000000000000000000000000000000000000000000000000000000000000000000000000000000",
    "00000000000000000000000000000000000000000000000000000000000000000000022000000000000000000000000000000000000000000000000000000000",
    "00000000000000000000000000000000000000000000000000000000000002222222222222000000000000000000000000000000000000000000000000000000",
    "00000000000000000000000000000000000000000000000000000000000002222222222222000000000000000000000000000000000000000000000000000000",
    "00000000000000000000000000000000000000000000000000000000000002222222222222022222000000000000000000000000000000000000000000000000",
    "00000000000000000000000000000000000000000000000000000000000002222222222222222222200000000000000000000000000000000000000000000000",
    "00000000000000000000000000000000000000000000000000000000000002222222222222222222200000000000000000000000000000000000000000000000",
    "00000000000000000000000000000000000000000000000000000000000002222222222222222222000000000000000000000000000000000000000000000000",
    "00000000000000000000000000000000000000000000000000000000000002222222222222222222200000000000000000000000000000000000000000000000",
    "00000000000000000000000000000000000000000000000000000000000002222222222222222222000000000000000000000000000000000000000000000000",
    "00000000000000000000000000000000000000000000000000000000000002222222222222222222222222200000000000000000000000000000000000000000",
    "00000000000000000000000000000000000000000000000000222200000002222222222222222222222222200000000000000000000000000000000000000000",
    "00000000000000000000000000000000000000000000000000222200000002222222222222222222222222200000000000000000000000000000000000000000",
    "00000000000000000000000000000000000000000000000000222222222222222222222222222222222222200000000000000000000000000000000000000000",
    "00000000000000000000000000000000000000000000000000222222222222222222222222222222222222200000000000000000000000000000000000000000",
    "00000000000000000000000000000000000000000000000000222222222222222222222222222222222222200000000000000000000000000000000000000000",
    "00000000000000000000000000000000000000000000000000222222222222222222222222222222222222200000000000000000000000000000000000000000",
    "00000000000000000000000000000000000000000000000000222222222222222222222222222222222222200000000000000000000000000000000000000000",
    "00000000000000000000000000000000000000000000000000222222222222222222222222000000222222222222222222222222220000000000000000000000",
    "00000000000000000000000000000000000000000000000000222222222222222222222222000000222222222222222222222222222000200000000000000000",
    "00000000000000000000000000000000000000000000000000222222222222222222222222000000222222222222222222222222222202220000000000000000",
    "00000000000000000000000000000000000000000000000000222222222222222222222222000000222222222222222222222222222222222000000000000000",
    "00000000000000000000000000000000000000000000000000222222222222222222222222000000222222222222222222222222222222222000000000000000",
    "00000000000000000000000000000000000000000000000000222222222222222222222222222222222222222222222222222222222222222000000000000000",
    "00000000000000000000000000000000000000000000000000222222222222222222222222222222222222222222222222222222222222222000000000000000",
    "00000000000000000000000000000000000000000000000000222222222222222222222222222222222222222222222222222222222222222200000000000000",
    "00000000000000000000000000000000000000000000000000222222222222222222222222222222222222222222222222222222222222222200000000000000",
    "00000000000000000000000000000000000000000000000000222222222222222222222222222222222222222202222222222222222222222200000000000000",
    "00000000000000000000000000000000000000000000000000222222222222222222222222222222222222220000022222222222222222222222000000000000",
    "00000000000000000000000000000000000000000000000000222222222222222222222222222222222222220000022222222222222222222222200000000000",
    "00000000000000000000000000000000000000000000000000222222222222222222222222220000000000000000022222222222222222222222220000000000",
    "00000000000000000000000000000000000000000000000000222222222222222222222222220000000000000000022222222222222222222222220000000000",
    "00000000000000000000000000000000000000000000000000222222222222222222222222220000000000000000022222222222222222222222220000000000",
    "00000000000000000000000000000000000000000000000000222222222222222222222222220000000000000000022222222222222222222222222220000000",
    "00000000000000000000000000000000000000000000000000222222222222222222222222220000000000000000022222222222222222222222222220000000",
    "00000000000000000000000000000000000000000000000000022200000000000000222222220000000000000000022222222222222222222222222220000000",
    "00000000000000000000000000000000000000000000000000000000000000000000222222220000000000000000022222222222222222222222222220000000",
    "00000000000000000000000000000000000000000000000000000000000000000000222222220000000000000000022222222222222222222222222220000000",
    "00000000000000000000000000000000000000000000000000000000000000000000222222220000000000000000022222222222222222222222222220000000",
    "00000000000000000000000000000000000000000000000000000000000000000000222222222000000000000000022222222222222222222222222220000000",
    "00000000000000000000000000000000000000000000000000000000000000000000222222222000000000000000022222222222222222222222222220000000",
    "00000000000000000000000000000000000000000000000000000000000000000000222222222200000000000000022220000000000000222222222220000000",
    "00000000000000000000000000000000000000000000000000000000000022222222222222222200000000000000022220000000000000222222222200000000",
    "00000000000000000000000000000000000000000000000000000000000022222222222222222200000000000000022220000000000000222222222200000000",
    "00000000000000000000000000000000000000000000000000000000000222222222222222222200000000000000022220000000000000222222222200000000",
    "00000000000000000000000000000000000000000000000000000000000222222222222222222200000000000000022220000000000000222222222200000000",
    "00000000000000000000000000000000000000000000000000000000002222222222222222222200000000000000022220000000000000222222222200000000",
    "00000000000000000000000000000000000000000000000000000000002222222222222222222220000000000000022222000222222222222222222200000000",
    "00000000000000000000000000000000000000000000000000000000022222222222222222222220000000000000022222222222222222222222222200000000",
    "00000000000000000000000000000000000000000000000000000000022222222222222222222220000000000000022222222222222222222222222000000000",
    "00000000000000000000000000000000000000000000000000000000222222222222222222222220000000000000022222222222222222222222222000000000",
    "00000000000000000000000000000000000000000000000000000000222222220000000000000020000000000000022222222222222222222222222000000000",
    "00000000000000000000000000000000000000000000000000000002222222220000000000000000000000000000022222222222222222222222220000000000",
    "00000000000000000000000000000000000000000000000000000002222222200000000000000000000000000000022222222222222222222222220000000000",
    "00000000000000000000000000000000000000000000000000000002222222200000000000000000000000000000022222222222222222222222220000000000",
    "00000000000000000000000000000000000000000000000000000022222222000000000000000000000000000000022222222222222222222222220000000000",
    "00000000000000000000000000000000000000000000000000000022222220000000000000000000000000000000022222222222222222222222220000000000",
    "00000000000000000000000000000000000000000000000000000222222200000000000000000000000000000000022222222222222222222222220000000000",
    "00000000000000000000000000000000000000000000000000000222222200000000000000000000000000000000000002222220000000022222222222000000",
    "00000000000000000000000000000000000000000000000000002222222000000000000000000000000000000000000002222200000000022222222222000000",
    "00000000000000000000000000000000000000000000000000002222222000000000000000000000000000000000000002222200000000022222222222000000",
    "00000000000000000000000000000000000000000000000022222222220000000000000000000000000000000000000002222200000000022222222222000000",
    "00000000000000000000000000000000000000000000000222222222222000000000000000000000000000000000000002222200000000022222222222000000",
    "00000000000000000000000000000000000000000000000222222222222200000000000000000000000000000000000002222200000000022222222222000000",
    "00000000000000000000000000000000000000000000000222222222222200000000000000000000000000000000000002222200000000002222222222220000",
    "00000000000000000000000000000000000000000000000222222222222200000000000000000000000000000000000002222200000000000000222222220000",
    "00000000000000000000000000000000000000000000000000022222222200000000000000000000000002222222222222222222222220000000222222220000",
    "00000000000000000000000000000000000000000000000000002222222200000000000000000000000022222222222222222222222222222222222222220000",
    "00000000000000000000000000000000000000000000000000022222222200000000000000000000000022222222222222222222222222222222222222220000",
    "00000000000000000000000000000000000000000000000000022222222000000000000000000000000002222222222222222222222222222222222222220000",
    "00000000000000000000000000000000000000000000000000022222200000000000000000000000000000022222222222222222222222222222222222220000",
    "00000000000000000000000000000000000000000000000000022222200000000000000000000000000000022222222222222222222222222222222222220000",
    "00000000000000000000000000000000000000000000000000002222200000000000000000000000000000022222222222222222222222222222222222220000",
    "00000000000000000000000000000000000000000000000000022222200000000000000000000000000000022222222222222222222222222222200000000000",
    "00000000000000000000000000000000000000000000000000022222200000000000000000000000000000022222222222222222222222222222222000000000",
    "00000000000000000000000000000000000222222222222222222222200000000000000000000000000000022222200000000000000002222222222000000000",
    "00000000000000000000000000000000002222222222222222222222200000000000000000000000000000022222200000000000000002222222222000000000",
    "00000002222222000000000000000000002222222222222222222222200000000000000000000000000000022222200000000000000002222222220000000000",
    "00022222222222000000000000002222222222222222222222222222200000000000000000000000000002222222200000000000000002222222200000000000",
    "00022222222222000000000000022222222222222222222222222222200000000000000000000000000002222222200000000000000002222222200000000000",
    "00022222222222000000000000022222222222222222222222222222200000000000000000000000000002222222200000000000000002222222200000000000",
    "00022222222222000000000000022222222222222222222222222222222222000222222000000000000002222222200000022222222222222222200000000000",
    "00002222222222000000000000022222222222222000000000022222222222222222222222222000000002222222200000022222222222222222200000000000",
    "00002222222222000000000000022222222222222000000000022222222222222222222222222200000002222222200000022222222222222222200000000000",
    "00002222222222002220000000022222222222222000000000022222222222222222222222222222222222222222200000222222222222222222200000000000",
    "00002222222222022222222222222222222222222000000000022222222222222222222222222222222222222222200000022222222222222222222222000000",
    "00002222222222022222222222222222222222222000000000022222222222222222222222222222222222222222200000022222222222222222222222000000",
    "00002222222222022222222222222222222222222000000000022222222222222222222222222222222222222222200000022222222222222222222222000000",
    "00002222222222222222222222222222222222222000000000022222222222222222222222222222222222222222200000022222222222222222222222000000",
    "00002222222222222222222222222222222222222000000000022222222222222222222222222222222222222222200000022222222222222222222222000000",
    "00002222222222222222000000022222222222222222222222222222222200000000022222222222222222222222200000022222222222222222222222200000",
    "00022222222222222222000000022222222222222222222222222000022200000000022222222200002222222222200000022222222222222222222222200000",
    "00022222222222222222000000022222222222222222222222222000022200000000022222222200002222222222200000022222222222222222222222200000",
    "00022222222222222222000000022222222222222222222222222000022200000000022222222200002222222222200000022222222222222222222222200000",
    "00022222222222222222000222222222222222222222222222222000022200000000022222222200002222222222200000022222222222222222222222200000",
    "00022222222222222222000222222222222222222222222222222000022200000000022222222200002222222222200000022222222222222222222222200000",
    "00022222222222222222000222222222222222222222222222222222222200000000022222222200002222222222200000022222222222222222222222200000",
    "00022222222222222222000222222222222222222222222222222222222200000000022222222200002222222222222222222222222222222222222222200000",
    "00022222222222222222000222222222222222222222222222222222222200000000022222222200002222222222222222222222222222222222222222200000",
    "00022222222222000000000222222222222222222222222222222222222200000000022222222222222222222222222222222222222222222222222222200000",
    "00022222222222000000000222222222222222222222222222222222222222222222222222222222222222222222222222222222222222222222222222200000",
    "00022222222222222222000222222222222222222222222222222222222222222222222222222222222222222222222222222222222222222222222222200000",
    "00022222222222222222200222222222222222222222222222222222222222222222222222222222222222222222222222222222222222222222222222200000",
    "00022222222222222222200222222222222222222222222222222222222222222222222222222222222222222222222222222222222222222222222222200000",
    "00002222222222222222200222222222222222222222222222222222222222222222222222222222222222222222222222222222222222222222222222200000",
    "00000000222222222222200222222222222222222222222222222222222222222222222222222222222222222222222222222222222222222222222222200000",
    "00000000222222222222200222222222222222222222222222222222222222222222222222222222222222000000000000022222222222222222222222200000",
    "00000000222222222222200222222222222222222222222222222222222222222222222222222222222222000000000000022222222222222222222222200000",
    "00000000222220002222222222222222222222222222222200000000022222222222222222222222222222222222222222222222222222222222222222200000",
    "00000000000000002222222222222222222222222222222200000000022222222222222222222222222222222222222222222222022222222222222222000000",
    "00000000000000002222222222222222220000222222222000000000022222000000000222222200222222222222222222222222022222222222222222200000",
    "00000000000000002222222222222222220000222222222000000000022220000000000002222200222222222222222222222222022222222222222222200000",
    "00000000000000002222222222222222220000222222222222222222222220000000000002222200222222222222222222222222022222222222222222200000",
    "00000000000000002222222222222222220000222222222222222222222220000000000022222200002222000000000000000000022222222222222222200000",
    "00000000000000002222222222222222220000222222222222222222222220000000000222222200002222000000000000000000022222222222222222200000",
    "00000000000000002222222222222222220000222222222222222222222220000000000222222200002222000000000000000000022222222222222222200000",
    "00000000000000000000000000000000000000222222222000000000022220000000000222222200002222000000000000000000022222222222222000000000",
    "00000000000000000000000000000000000000222220000000000000022220000000000222222222222222000000000000000000000000000000000000000000",
    "00000000000000000000000000000000000000222220000000000000022222222222222222222222222222000000000000000000000000000000000000000000",
    "00000000000000000000000000000000000000222200000000000000022222222222222222222222222222000000000000000000000000000000000000000000",
    "00000000000000000000000000000000000000000000000000000000022222222222222222222222222222000000000000000000000000000000000000000000",
    "00000000000000000000000000000000000000000000000000000000022222222222222222222222222220000000000000000000000000000000000000000000",
    "00000000000000000000000000000000000000000000000000000000000000022222222222222200000000000000000000000000000000000000000000000000",
    "00000000000000000000000000000000000000000000000000000000000000000000000222222000000000000000000000000000000000000000000000000000",
    "00000000000000000000000000000000000000000000000000000000000000000000000000000000000000000000000000000000000000000000000000000000",
    "00000000000000000000000000000000000000000000000000000000000000000000000000000000000000000000000000000000000000000000000000000000",
    "00000000000000000000000000000000000000000000000000000000000000000000000000000000000000000000000000000000000000000000000000000000",
    "00000000000000000000000000000000000000000000000000000000000000000000000000000000000000000000000000000000000000000000000000000000"
  ],
  "agent_spawn_pool": [
    [58, 16],
    [73, 85],
    [12, 94],
    [120, 112]
  ],
  "npc_spawn_pool": [
    [84, 11],
    [98, 70],
    [32, 80],
    [73, 115]
  ],
  "station_pool": [{"x": 112, "z": 29, "dx": 3, "dz": 3}, {"x": 74, "z": 39, "dx": 3, "dz": 3}, {"x": 99, "z": 83, "dx": 3, "dz": 3}, {"x": 40, "z": 90, "dx": 3, "dz": 3}],
  "max_battery": 200,
  "max_steps": 1000,
  "hero_id": 37,
  "npc_ids": null,
  "local_view_size": 21
}
