{
  "schema_version": 1,
  "map_id": 6,
  "size": [128, 128],
  "custom_map": [
    "00000000000000000000000000000000000000000000000000000000000000000000000000000000000000000000000000000000000000000000000000000000",
    "00000000000000000000000000000000000000000000000000000000000000000000000000000000000000000000000000000000000000000000000000000000",
    "00000000000000000000000000000000000000000000000000000000000000000000000000000000000000000000000000000000000000000000000000000000",
    "00000002222222222220000000000000000000000000000000000000000000000000000000000000000000000000000000000000000000000000000000000000",
    "00000002222222222220000000000000000000000000000000000000000000000000000000000000000000000000000000000000000000000000000000000000",
    "00000002222222222220000000000000000000000000000000000000000000000000000000000000000000000000000000000000000000000000000000000000",
    "00000002222222222220000000000000000000000000000000000000000000000000000000000000000000000000000000000000000000000000000000000000",
    "00000002222222222220000000000000000000000000000000000000000000000000000000000000000000000000000002222222222222222222200000000000",
    "00000002222222222220000000000000000000000000000000000000000000000000000000000000000000000000000002222222222222222222200000000000",
    "00000002222222222220000000000000000000000000000000000000000000000000000000000000000000000000000002222222222222222222200000000000",
    "00000002222222222220000000000000000000000000000000000000000000000000000000000000000000000000000002222222222222222222200000000000",
    "00000002222222222220000000000000000000000000000000000000000000000000000000000000000000000000000002222222222222222222200000000000",
    "00000002222222222222222222222222200000000000000000000000000000000000000000000000000000000000000002222222222222222222200000000000",
    "00000002222222222222222222222222222222222200000000000000000000000000000000000000000000000000000002222222222222222222200000000000",
    "00000002222222222222222222222222222222222222000000000000000000000000000000000000000000000000000002222222222222222222200000000000",
    "00000002222222222222222222222222222222222222220000000000000000000000000000000000000000000000000022222222222222222222200000000000",
    "00000002222222222222222222222222222222222222222000000000002222000000000000000222222222222222222222222222222222222222200000000000",
    "00000002222222222222222222222222222222222222222200000000222222000000000000000222222222222222222222222222222222222222200000000000",
    "00000002222222222222222222222222222222222222222222222222222222000000000000000222222222222222222222222222222222222222200000000000",
    "00000002222222222222222222222222222222222222222222222222222222000000000000000222222222222222222222222222222222222222200000000000",
    "00000002222222222222222222222222222222222222222222222222222222000000000000000222222222222222222222222222222222222222200000000000",
    "00000002222222222222222222222222222222222222222222222222222222000000000000000222222222222222222222222222222222222222200000000000",
    "00000002222222222222222222222222222222222222222222222222222222000000000000000222222222222222222222222222222222222222200000000000",
    "00000002222222222222222222222222222222222222222222222222222222000000000000000222222222222222222222222222222222222222200000000000",
    "00000002222222222222222222222222222222222222222222222222222222000000000000000222222222222222222222222222222222222222200000000000",
    "00000002222222222222222222222222222222222222222222222222222222000000000000000222222222222222222222222222222222222222200000000000",
    "00000002222222222222222222222222222222222222222222222222222222000000000000000222222222222222222222222222222222222222200000000000",
    "00000222222222222222222222222222222222222222222222222222222222000000000000000222222222222222222222222222222222222222200000000000",
    "00000222222222222222222222222222222222222222222222222222222222000000000000000222222222222222222222222222222222222222200000000000",
    "00000222222222222222222222222222222222222222222222222222222222000000000000000222222222222222222222222222222222222222200000000000",
    "00000222222222222222222222222222222222222222222222222222222222000000000000000222222222222222222222222222222222222222222222000000",
    "00000222222222222222222222222222222222222222222222222222222222000000000000000222222222222222222222222222222222222222222222000000",
    "00000222222222222222222222222222222222222222222222222222222222000000000000000222222222222222222222222222222222222222222222000000",
    "00000222222222222222222222222222222222222222222222222222222222000000000000000222222222222222222222222222222222222222222222000000",
    "00000222222222222222222222222222222222222222222222222222222222000000000000000222222222222222222222222222222222222222222222000000",
    "00000222222222222222222222222222222222222222222222222222222222000000000000000222222222222222222222222222222222222222222222000000",
    "00000222222222222222222222222222222222222222222222222222222222000000000000000222222222222222222222222222222222222222222222000000",
    "00000222222222222222222222222222222222222222222222222222222222000000000000000222222222222222222222222222222222222222222222000000",
    "00000222222222222222222222222222222222222222222222222222222222000000000000000222222222222222222222222222222222222222222222000000",
    "00000222222222222222222222222222222222222222222222222222222222000000000000000222222222222222222222222222222222222222222220000000",
    "00000222222222222222222222222222000000000000000000022222222222000000000000000222222222000000000000000002222222222222222222000000",
    "00000222222222222222222222222222000000000000000000022222222222000000000000000222222222000000000000000002222222222222222222000000",
    "00000222222222222222222222222222000000000000000000022222222222000000000000000222222222000000000000000002222222222222222222000000",
    "00000222222222222222222222222222000000000000000000022222222222000000000000000222222222000000000000000002222222222222222222000000",
    "00000222222222222222222222222222000000000000000000022222222222000000000000000222222222000000000000000002222222222222222222000000",
    "00000222222222222222222222222222000000000000000000022222222222000000000000000222222222000000000000000002222222222222222222000000",
    "00000022222222222222222222222222000000000000000000022222222222000000000000000222222222000000000000000002222222222222222222000000",
    "00000000002222220002222222222222000000000000000000022222222222000000000000000222222222000000000000000002222222222222200000000000",
    "00000000002222220002222222222222000000000000000000022222222222000000000000000222222222000000000000000002222222222222200000000000",
    "00000000002222220002222222222222000000000000000000022222222222000000000000000222222222000000000000000002222222222222200000000000",
    "00000000002222220002222222222222000000000000000000022222222222000000000000000222222222000000000000000002222222222222200000000000",
    "00000000002222220002222222222222000000000000000000022222222222222222222222222222222222000000000000000002222222222222200000000000",
    "00000000002222220002222222222220000222222222222222222222222222222222222222222222222222000000000000000002222222222222200000000000",
    "00000000002222220000022000000000000222222222222222222222222222222222222222222222222222000000000000000002222222222222200000000000",
    "00000000002222220000022000000000000222222222222222222222222222222222222222222222222222000000000000000002222222222222200000000000",
    "00000000002222222220222000000000000222222222222222222222222222222222222222222222222222000000000000000002222222222222200000000000",
    "00000000002222222222222000000000000222222222222222222222222222222222222222222222222222000000000000000002222222222222200000000000",
    "00000000002222222222222000000000000222222222222222222222222222222222222222222222222222000000000000000002222222222222200000000000",
    "00000002222222222222222000000000000222222220000222022222222222222222222222222222222222000000000000000002222222222222200000000000",
    "00000002222222222222222222222222222222220000000000022222222222222222222222222222222220000000000000000002222222222222200000000000",
    "00000002222222222222222222222222222222220000000000022222222222222222200000000000000000222222222222222222222222222222200000000000",
    "00000002222222222222222222222222222222220000000000022222222222222222200000000000000002222222222222222222222222222222200000000000",
    "00000002222222222222222222222222222222220000000000022222222222222222200000000000000022222222222222222222222222222222200000000000",
    "00000002222222222222222222222222222222220000000000022222222222222222200000000000000222222222222222222222222222222222200000000000",
    "00000002222222222222222222222222222222200000000000022222222222222222200000000000002222222222222222222222222222222222200000000000",
    "00000002222222222222222222222222222222200000000000022222222222222222200000000000002222222222222222222222222222222222200000000000",
    "00000000022222222222222222222222222220000000000000022222222222222222200000000000002222222222222222222222222222222222222222000000",
    "00000000000000000022222222000000000000000000000000022222222222222222200000000000002222222222222222222222222222222222222222000000",
    "00000000000000000022222222000000000000000000000000022222222222222222200000000000002222222222222222222222222222222222222222000000",
    "00000000000000000000222200000000000000000000000000022222222222222222200000000000002222222222222222222222222222222222222222000000",
    "00000000000000000000222200000000000000000000000000000000222222222222200000000000002222222222222222222222222222222222222222000000",
    "00000000000000000000222200000000000000000000000000000000222222222222200000000000002222222222222222222222222222222222222222000000",
    "00000000000000000000222200000000000000000000000000000000222222222222200000000000002222222222202222222222222222222222222222000000",
    "00000000000000022222222222222000000000000000000000000000222222222222200000000000002222222222202222222222222222222222222222000000",
    "00000000000000222222222222222200000000000000000000000000222222222222200000000000002222222222202222222222222222222222222222000000",
    "00000000000000222222222222222220000000000000000000000000222222222222200000000000002222222222202222222222222222222222222222000000",
    "00000000000002222222222222222220000000000000000002222222222222222222200000000000002222222222202222222222222222222222222222000000",
    "00000000000022222222222222222222222222222222222222222222222222222222200000000000002222222222202222222222222222222222222222000000",
    "00000000022222222222222222222222222222222222222222222222222222222222200000000000002222222222202222222222222222222222222222000000",
    "00000000222222222222222222222222222222222222222222222222222222222222200000000000002222222222202222222222222222222222222222000000",
    "00000000222222222222222222222222222222222222222222222222222222222222222222222222222222222222200222222222222222222222222222000000",
    "00000000222222222222222222222222222000000000000222222222222222222222222222222222222222222222202222222222222222222222222222000000",
    "00000000222222222222222222222222222000000000000222222222222222222222222222222222222222222222202222222222222222222222222222000000",
    "00000000222222222222222222222222222000000000000222222222222222222222222222222222222222222222202222222222222222222222222222000000",
    "00000000222222222222222222222222222000000000000222222222222222222222222222222222222222222222202222222222222222222222222222000000",
    "00000000222222222222222222222222222000000000000222222222222222222222222222222222222222222222202222222222222222222222222222000000",
    "00000000222222222222222222222222222000000000000222222222222222222222222222222222222222222222202222222222222222222222222222000000",
    "00000000222222222222222222222222222000000000000222222222222222222222222222222222222222222222202222222222222222222222222222000000",
    "00000000222222222222222222222222222000000000000222222222220000000000000022222222222222222222202222222222222000000000000000000000",
    "00000000222222222222222222222222222000000000000222222222220000000000000022222222222222222222202222222222222000000000000000000000",
    "00000000222222222222222222222222222000000000000022222222220000000000000022222222222222222222202222222222222000000000000000000000",
    "00000000222222222222222222222222222000000000000000222222220000000000000022222222222222222222202222222222222000000000000000000000",
    "00000000222222222222222222222222222000000000000000222222220000000000000022222222222222222222202222222222222000000000000000000000",
    "00000000222222222222222222222222222000000000000000000222220000000000000022222222222222222222200000000000000000000000000000000000",
    "00000000222222222222222222222222220000000000000000000222220000000000000022222222222222222222200000000000000000000000000000000000",
    "00000000222222222222222222222222220000000000000000000222220000000000000022222222222222222222200000000000000000000000000000000000",
    "00000000222222222222222222222222200000000000000000000222220000000000000022222222222222222222200000000000000000000000000000000000",
    "00000000222222222222222222222222000000000000000000000222220000000000000022222222222222222222200000000000000000000000000000000000",
    "00000000222222222222222222222220000000000000000000000222220000000000000022222222222222222222200000000000000000000000000000000000",
    "00000000222222222222222222222200000022222222000000000222220000000000000022222222222222222222200000000000000000000000000000000000",
    "00000000222222222220000000000000000022222222000000000222220000000000000022222222222222222222200000000000000000000000000000000000",
    "00000000222222222220000000000000000222222222000000000222222222222222222222222222222222222222200000000000000000000000000000000000",
    "00000000222222222220222222222222222222222222000000000222222222222222222222222222222222222222200000000000000000000000000000000000",
    "00000000222222222220222222222222222222222222000000000222222222222222222222222222222222222222200000000000000000000000000000000000",
    "00000000222222222220222222222222222222222222000000000222222222222222222222222222222222222222200000000000000000000000000000000000",
    "00000000222222222220222222222222222222222222000000000222222222222222222222222222222222222222200000000000000000000000000000000000",
    "00000000222222222220222222222222222222222222000000000222222222222222222222222222222222222222200000000000000000000000000000000000",
    "00000000222222222220222222222222222222222222000000000222222222222222222222222222222222222222200000000000000000000000000000000000",
    "00000000222222222220222222222222222222222222000000000222222222222222222222222222222222222222200000000000000000000000000000000000",
    "00000000222222222220222222222222222222222222000000000222222222222222222222222222222000000000000000000000000000000000000000000000",
    "00000000222222222220222222222222222222222222000000000222222222222222222222222222222000000000000000000000000000000000000000000000",
    "00000000222222222220222222222222222222222222000000000222222222222222222222222222222000000000000000000000000000000000000000000000",
    "00000000222222222220222222222222222222222222222222222222222222222222222222222222222000000000000000000000000000000000000000000000",
    "00000000222222222220222222222222222222222222222222222222222222222222222222222222222000000000000000000000000000000000000000000000",
    "00000222222222222220222222222222222222222222222222222222222222222222222222222222222000000000000000000000000000000000000000000000",
    "00000222222222222222222222222222222222222222222222222222222222222222222222222222222000000000000000000000000000000000000000000000",
    "00000222222222222222222222222222222222222222222222222222222222222222222222222222222000000000000000000000000000000000000000000000",
    "00000222222222222222222222222222222222222222222222222222222222222222222222222222222000000000000000000000000000000000000000000000",
    "00000222222222222222222222222222222222222222222222222222222222222222222222222222222000000000000000000000000000000000000000000000",
    "00000222222222222222222222222222222222222222222222222222222222222222222222222222222000000000000000000000000000000000000000000000",
    "00000222222222222222222222222222222222222222222222222222222222222222222222222222222000000000000000000000000000000000000000000000",
    "00000222222222222222222222222222222222222222222222222222222222222222222222222222222000000000000000000000000000000000000000000000",
    "00000222222222222222222222222222222222222222222222222222222222222222222222222222222000000000000000000000000000000000000000000000",
    "00000222222222222222222222222222222222222200000000000222222222222222222222222222222000000000000000000000000000000000000000000000",
    "00000222222222222222222222222222222222222200000000000222222222222222222222222222222000000000000000000000000000000000000000000000",
    "00000222222222222222222222222222222222222000000000000222222222222222222222222222222000000000000000000000000000000000000000000000",
    "00000000000000000000000000000000000000000000000000000222222222222222222222222222222000000000000000000000000000000000000000000000",
    "00000000000000000000000000000000000000000000000000000000000000000000000000000000000000000000000000000000000000000000000000000000"
  ],
  "agent_spawn_pool": [
    [32, 38],
    [104, 58],
    [16, 106],
    [63, 115]
  ],
  "npc_spawn_pool": [
    [22, 26],
    [114, 28],
    [22, 86],
    [76, 104]
  ],
  "station_pool": [{"x": 85, "z": 37, "dx": 3, "dz": 3}, {"x": 28, "z": 49, "dx": 3, "dz": 3}, {"x": 95, "z": 79, "dx": 3, "dz": 3}, {"x": 43, "z": 113, "dx": 3, "dz": 3}],
  "max_battery": 200,
  "max_steps": 1000,
  "hero_id": 37,
  "npc_ids": null,
  "local_view_size": 21
}
