{
  "schema_version": 1,
  "map_id": 3,
  "size": [128, 128],
  "custom_map": [
    "00000000000000000000000000000000000000000000000000000000000000000000000000000000000000000000000000000000000000000000000000000000",
    "02222222222222222222222222222222222222222222222222222222222222222222222222222222222222222222222222222222222222222222222222222220",
    "02222222222222222222222222222222222222222222222222222222222222222222222222222222222222222222222222222222222222222222222222222220",
    "02222222222222222222222222222222222222222222222222222222222222222222222222222222222222222222222222222222222222222222222222222220",
    "02222222222222222222222222222222222222222222222222222222222222222222222222222222222222222222222222222222222222222222222222222220",
    "02222222222222222222222222222222222222222222222222222222222222222222222222222222222222222222222222222222222222222222222222222220",
    "02222222222222222222222222222222222222222222222222222222222222222222222222222222222222222222222222222222222222222222222222222220",
    "02222222222222222222222222222222222222222222222222222222222222222222222222222222222222222222222222222222222222222222222222222220",
    "02222222222222222222222222222222222222222222222222222222222222222222222222222222222222222222222222222222222222222222222222222220",
    "02222222222222222222222222222222222222222222222222222222222222222222222222222222222222222222222222222222222222222222222222222220",
    "02222222222222222222222222222222222222000002222222222222222222222222222222222222222220000022222222222220000000000000002222222220",
    "02222222222000000000000002222222222222000000222222222222222222222222222222222222222200000022222222222220000000000000002222222220",
    "02222222222000000000000002222222222222000000222222222222222222222222222222222222222200000022222222222220000000000000002222222220",
    "02222222222000000000000002222222222222000000222222222222222222222222222222222222222200000022222222222220000000000000002222222220",
    "02222222222000000000000002222222222222000000222222222222222222222222222222222222222200000022222222222220000000000000002222222220",
    "02222222222000000000000002222222222222000000222222222222222222222222222222222222222200000022222222222220000000000000002222222220",
    "02222222222000000000000002222222222222000000222222222222222222222222222222222222222200000022222222222220000000000000002222222220",
    "02222222222000000000000002222222222222000000222222222222222222222222222222222222222200000022222222222220000000000000002222222220",
    "02222222222000000000000002222222222222000000222222222222222222222222222222222222222200000022222222222220000000000000002222222220",
    "02222222222000000000000002222222222222000000222222222222222222222222222222222222222200000022222222222220000000000000002222222220",
    "02222222222000000000000002222222222222000000222222222222222222222222222222222222222200000022222222222220000000000000002222222220",
    "02222222222000000000000002222222222222000000222222222222222222222222222222222222222200000022222222222220000000000000002222222220",
    "02222222222000000000000002222222222222000000222222222222222222222222222222222222222200000022222222222220000000000000002222222220",
    "02222222222000000000000002222222222222000000222222222222222222222222222222222222222200000022222222222220000000000000002222222220",
    "02222222222000000000000002222222222222000000222222222222222222222222222222222222222200000022222222222220000000000000002222222220",
    "02222222222000000000000002222222222222000000222222222222222222222222222222222222222200000022222222222222222222222222222222222220",
    "02222222222222222222222222222222222222000000222222222222222222222222222222222222222200000022222222222222222222222222222222222220",
    "02222222222222222222222222222222222222222222222222222222222222222222222222222222222222222222222222222222222222222222222222222220",
    "02222222222222222222222222222222222222222222222222222222222222222222222222222222222222222222222222222222222222222222222222222220",
    "02222222222222222222222222222222222222222222222222222222222222222222222222222222222222222222222222222222222222222222222222222220",
    "02222222222222222222222222222222222222222222222222222222222222222222222222222222222222222222222222222222222222222222222222222220",
    "02222222222222222222222222222222222222222222222222222222222222222222222222222222222222222222222222222222222222222222222222222220",
    "02222222222222222222222222222222222222222222222222222222222222222222222222222222222222222222222222222222222222222222222222222220",
    "02222222222222222222222222222222222222222222222222222222222222222222222222222222222222222222222222222222222222222222222222222220",
    "02222222222222222222222222222222222222222222222222222222222222222222222222222222222222222222222222222222222222222222222222222220",
    "02222222222222222222222222222222222222222222222222222222222222222222222222222222222222222222222222222222222222222222222222222220",
    "02222222222222222222222222222222222222222222222222222222222222222222222222222222222222222222222222222222222222222222222222222220",
    "02222222222222222222222222222222222222222222222222222222222222222222222222222222222222222222222222222222222222222222222222222220",
    "02222222222000000000000000022222222222222222222222222000000000000000000022222222222222222222222222220000000000000000022222222220",
    "02222222222000000000000000022222222222222222222222222000000000000000000022222222222222222222222222220000000000000000002222222220",
    "02222222222000000000000000022222222222222222222222222000000000000000000022222222222222222222222222220000000000000000002222222220",
    "02222222222000000000000000022222222222222222222222222000000000000000000022222222222222222222222222220000000000000000002222222220",
    "02222222222000000000000000022222222222222222222222222000000000000000000022222222222222222222222222220000000000000000002222222220",
    "02222222222000000000000000022222222222222222222222222000000000000000000022222222222222222222222222220000000000000000002222222220",
    "02222222222222222222222222222222222222222222222222222222222222222222222222222222222222222222222222222222222222222222222222222220",
    "02222222222222222222222222222222222222222222222222222222222222222222222222222222222222222222222222222222222222222222222222222220",
    "02222222222222222222222222222222222222222222222222222222222222222222222222222222222222222222222222222222222222222222222222222220",
    "02222222222222222222222222222222222222222222222222222222222222222222222222222222222222222222222222222222222222222222222222222220",
    "02222222222222222222222222222222222222222222222222222222222222222222222222222222222222222222222222222222222222222222222222222220",
    "02222222222222222222222222222222222222222222222222222222222222222222222222222222222222222222222222222222222222222222222222222220",
    "02222222222222222222222222222222222222222222222222222222222222222222222222222222222222222222222222222222222222222222222222222220",
    "02222222222222222222222222222222222222222222222222222222222222222222222222222222222222222222222222222222222222222222222222222220",
    "02222222222222222222222222222222222222222222222222222222222222222222222222222222222222222222222222222222222222222222222222222220",
    "02222222222222222222222222222222222222222222222222222222222222222222222222222222222222222222222222222222222222222222222222222220",
    "02222222222222222222222222222222222222000000222222222222222222222222222222222222222200000022222222222222222222222222222222222220",
    "02222222222222222222222222222222222222000000222222222222222222222222222222222222222200000022222222222222222222222222222222222220",
    "02222222222222222222222222222222222222000000222222222222222222222222222222222222222200000022222222222222222222222222222222222220",
    "02222222222222222222222222222222222222000000222222222222222222222222222222222222222200000022222222222222222222222222222222222220",
    "02222222222222222222222222222222222222000000222222222222222222222222222222222222222200000022222222222222222222222222222222222220",
    "02222222222222222222222222222222222222000000222222222222222222222222222222222222222200000022222222222222222222222222222222222220",
    "02222222222222222222222222222222222222000000222222222222222222222222222222222222222200000022222222222222222222222222222222222220",
    "02222222222222222222222222222222222222000000222222222222222222222222222222222222222200000022222222222222222222222222222222222220",
    "02222222222222222222222222222222222222000000222222222222222222222222222222222222222200000022222222222222222222222222222222222220",
    "02222222222222222222222222222222222222000000222222222222222222222222222222222222222200000022222222222222222222222222222222222220",
    "02222222222222222222222222222222222222000000222222222222222222222222222222222222222200000022222222222222222222222222222222222220",
    "02222222222222222222222222222222222222000000222222222222222222222222222222222222222200000022222222222222222222222222222222222220",
    "02222222222222222222222222222222222222000000222222222222222222222222222222222222222200000022222222222222222222222222222222222220",
    "02222222222222222222222222222222222222000000222222222222222222222222222222222222222200000022222222222222222222222222222222222220",
    "02222222222222222222222222222222222222000000222222222222222222222222222222222222222200000022222222222222222222222222222222222220",
    "02222222222222222222222222222222222222000000222222222222222222222222222222222222222200000022222222222222222222222222222222222220",
    "02222222222222222222222222222222222222000000222222222222222222222222222222222222222200000022222222222222222222222222222222222220",
    "02222222222222222222222222222222222222000000222222222222222222222222222222222222222200000022222222222222222222222222222222222220",
    "02222222222222222222222222222222222222000000222222222222222222222222222222222222222200000022222222222222222222222222222222222220",
    "02222222222222222222222222222222222222000000222222222222222222222222222222222222222222222222222222222222222222222222222222222220",
    "02222222222222222222222222222222222222222222222222222222222222222222222222222222222222222222222222222222222222222222222222222220",
    "02222222222222222222222222222222222222222222222222222222222222222222222222222222222222222222222222222222222222222222222222222220",
    "02222222222222222222222222222222222222222222222222222222222222222222222222222222222222222222222222222222222222222222222222222220",
    "02222222222222222222222222222222222222222222222222222222222222222222222222222222222222222222222222222222222222222222222222222220",
    "02222222222222222222222222222222222222222222222222222222222222222222222222222222222222222222222222222222222222222222222222222220",
    "02222222222222222222222222222222222222222222222222222222222222222222222222222222222222222222222222222222222222222222222222222220",
    "02222222222222222222222222222222222222222222222222222222222222222222222222222222222222222222222222222222222222222222222222222220",
    "02222222222222222222222222222222222222222222222222222222222222222222222222222222222222222222222222222222222222222222222222222220",
    "02222222222222222222222222222222222222222222222222222222222222222222222222222222222222222222222222222222222222222222222222222220",
    "02222222222222222222222222222222222222222222222222222222222222222222222222222222222222222222222222222222222222222222222222222220",
    "02222222222222222222222222222222222222222222222222222222222222222222222222222222222222222222222222222222222222222222222222222220",
    "02222222222000000000000000022222222222222222222222222220000000000000000002222222222222222222222222220000000000000000002222222220",
    "02222222222000000000000000022222222222222222222222222220000000000000000002222222222222222222222222220000000000000000002222222220",
    "02222222222000000000000000022222222222222222222222222220000000000000000002222222222222222222222222220000000000000000002222222220",
    "02222222222000000000000000022222222222222222222222222220000000000000000002222222222222222222222222220000000000000000002222222220",
    "02222222222000000000000000022222222222222222222222222220000000000000000002222222222222222222222222220000000000000000002222222220",
    "02222222222222222222222222222222222222222222222222222222222222222222222222222222222222222222222222222222222222222222222222222220",
    "02222222222222222222222222222222222222222222222222222222222222222222222222222222222222222222222222222222222222222222222222222220",
    "02222222222222222222222222222222222222222222222222222222222222222222222222222222222222222222222222222222222222222222222222222220",
    "02222222222222222222222222222222222222222222222222222222222222222222222222222222222222222222222222222222222222222222222222222220",
    "02222222222222222222222222222222222222222222222222222222222222222222222222222222222222222222222222222222222222222222222222222220",
    "02222222222222222222222222222222222222222222222222222222222222222222222222222222222222222222222222222222222222222222222222222220",
    "02222222222222222222222222222222222222222222222222222222222222222222222222222222222222222222222222222222222222222222222222222220",
    "02222222222222222222222222222222222222222222222222222222222222222222222222222222222222222222222222222222222222222222222222222220",
    "02222222222222222222222222222222222222222222222222222222222222222222222222222222222222222222222222222222222222222222222222222220",
    "02222222222222222222222222222222222222222222222222222222222222222222222222222222222222222222222222222222222222222222222222222220",
    "02222222222222222222222222222222222222222222222222222222222222222222222222222222222222222222222222222222222222222222222222222220",
    "02222222222222222222222222222222222222000000222222222222222222222222222222222222222200000022222222222222222222222222222222222220",
    "02222222222222222222222222222222222222000000222222222222222222222222222222222222222200000022222222222222222222222222222222222220",
    "02222222222222222222222222222222222222000000222222222222222222222222222222222222222200000022222222222222222222222222222222222220",
    "02222222222000000000000002222222222222000000222222222222222222222222222222222222222200000022222222222220000000000000002222222220",
    "02222222222000000000000002222222222222000000222222222222222222222222222222222222222200000022222222222220000000000000002222222220",
    "02222222222000000000000002222222222222000000222222222222222222222222222222222222222200000022222222222220000000000000002222222220",
    "02222222222000000000000002222222222222000000222222222222222222222222222222222222222200000022222222222220000000000000002222222220",
    "02222222222000000000000002222222222222000000222222222222222222222222222222222222222200000022222222222220000000000000002222222220",
    "02222222222000000000000002222222222222000000222222222222222222222222222222222222222200000022222222222220000000000000002222222220",
    "02222222222000000000000002222222222222000000222222222222222222222222222222222222222200000022222222222220000000000000002222222220",
    "02222222222000000000000002222222222222000000222222222222222222222222222222222222222200000022222222222220000000000000002222222220",
    "02222222222000000000000002222222222222000000222222222222222222222222222222222222222200000022222222222220000000000000002222222220",
    "02222222222000000000000002222222222222000000222222222222222222222222222222222222222200000022222222222220000000000000002222222220",
    "02222222222000000000000002222222222222000000222222222222222222222222222222222222222200000022222222222220000000000000002222222220",
    "02222222222000000000000002222222222222000000222222222222222222222222222222222222222200000022222222222220000000000000002222222220",
    "02222222222000000000000002222222222222000000222222222222222222222222222222222222222200000022222222222220000000000000002222222220",
    "02222222222000000000000002222222222222000000222222222222222222222222222222222222222200000022222222222220000000000000002222222220",
    "02222222222000000000000002222222222222222222222222222222222222222222222222222222222222222222222222222220000000000000022222222220",
    "02222222222222222222222222222222222222222222222222222222222222222222222222222222222222222222222222222222222222222222222222222220",
    "02222222222222222222222222222222222222222222222222222222222222222222222222222222222222222222222222222222222222222222222222222220",
    "02222222222222222222222222222222222222222222222222222222222222222222222222222222222222222222222222222222222222222222222222222220",
    "02222222222222222222222222222222222222222222222222222222222222222222222222222222222222222222222222222222222222222222222222222220",
    "02222222222222222222222222222222222222222222222222222222222222222222222222222222222222222222222222222222222222222222222222222220",
    "02222222222222222222222222222222222222222222222222222222222222222222222222222222222222222222222222222222222222222222222222222220",
    "02222222222222222222222222222222222222222222222222222222222222222222222222222222222222222222222222222222222222222222222222222220",
    "02222222222222222222222222222222222222222222222222222222222222222222222222222222222222222222222222222222222222222222222222222220",
    "00000000000000000000000000000000000000000000000000000000000000000000000000000000000000000000000000000000000000000000000000000000"
  ],
  "agent_spawn_pool": [
    [66, 22],
    [18, 56],
    [101, 64],
    [71, 111]
  ],
  "npc_spawn_pool": [
    [40, 3],
    [64, 62],
    [116, 76],
    [4, 118]
  ],
  "station_pool": [{"x": 46, "z": 33, "dx": 3, "dz": 3}, {"x": 88, "z": 33, "dx": 3, "dz": 3}, {"x": 93, "z": 85, "dx": 3, "dz": 3}, {"x": 33, "z": 93, "dx": 3, "dz": 3}],
  "max_battery": 200,
  "max_steps": 1000,
  "hero_id": 37,
  "npc_ids": null,
  "local_view_size": 21
}
