{
  "schema_version": 1,
  "map_id": 10,
  "size": [128, 128],
  "custom_map": [
    "00000000000000000000000000000000000000000000000000000000000000000000000000000000000000000000000000000000000000000000000000000000",
    "00000000000000000000000000000000000000000000000000000000000000000000000000000000000000000000000000000000000000000000000000000000",
    "00000000000000000000000000000000000000000000000000000000000000000000000000000000000000000000000000000000000000000000000000000000",
    "00000000000000000000000000000000000000000000000000000000000000000000000000000000000000000000000000000000000000000000000000000000",
    "00000000000000000000000000000000000000000000000000000000000000000000000000000000000000000000000000000000000000000000000000000000",
    "00000000000000000000000000000000000000000000000000000000000000000000000000000000000000000000000000000000000000000000000000000000",
    "00000000000000000000000000000000000000000000000000000000000000000000000000000000000000000000000000000000000000000000000000000000",
    "00000000000000000000000000000000000000000000000000000000000000000000000000000000000000000000000000000000000000000000000000000000",
    "00000000000000000000000000000000000000000000000000000000000000000000000000000000000000000000000000000000000000000000000000000000",
    "00000000000000000000000000000000000000000000000000000000000000000000000000000000000000000000000000000000000000000000000000000000",
    "00000000000000022222222222222222220022222222222222000000000002222222220000000002222222220000000000000000000222222000000000000000",
    "00000000000000222222222222222222220022222222222222000000000002222222220000000002222222220000000000000000000222222200000000000000",
    "00000000000000222222222222222222220022222222222222000000000002222222220000000002222222220000000000000000000222222200000000000000",
    "00000000000002222222222222222222220022222222222222000000000002222222220000000002222222220000000000000000000222222220000000000000",
    "00000000000222222222222222222222220022222222222222000000000002222222220000000002222222220000000000000000000222222222000000000000",
    "00000000002222222222222222222222220022222222222222022222222222222222220000000022222222220000222222222222222222222222220000000000",
    "00000000002222222222222222222222220022222222222222022222222222222222220000000222222222220000222222222222222222222222220000000000",
    "00000000000222222222222222222222220022222222222222022222222222222222220000000022222222220000222222222222222222222222222000000000",
    "00000000000222222222222222222222220000000222200000022222222222222222220000000222222222220000222222222222222222222222000000000000",
    "00000000000222222222222222222222220000000222222222022222222222222222220000000000022222220000222222222222222222222222000000000000",
    "00000000000000000000000222222222200000222222220000022222222222222222220000000000022222220000222222222222222222222222000000000000",
    "00000000000000000000000222222222200000222222220000022222222222222222220000000000022222220000222222222222222222222222000000000000",
    "00000000000000000000000222222222200000222222220000022222222222222222220000000000022222220000222222222222200000000000000000000000",
    "00000000000000000000000222222222200000222222222222022222222222222222220000000222222222220000222222222222200000000000000000000000",
    "00000000000000000000000222222222200000222222220000022222222222222222220000000000022222220000222222222222200000000000000000000000",
    "00000000000000000000000222222222200000222222220000022222222222222222220000000000022222220000222222222222200000000000000000000000",
    "00000000000000000000000222222222200000222222220000022222222222222222220000000000022222220000222222222222200000000000000000000000",
    "00000000000000000000000222222222200000222222220000022222222222222222220000000000022222220000222222222222200000000000000000000000",
    "00000000000000000000000222222222200000222222220000022222222222222222222222200000022222220000222222222222200000000000000000000000",
    "00000000000000000000000222222222200000222222222222022222222222222222222222200000022222220000222222222222200000000000000000000000",
    "00000000000000000000000222222222200000222222222222022222222222222222222222200000022222220000222222222222200000000000000000000000",
    "00000000000222222222222222222222222220222222222000022222222222222222222222200000002222200022222222222222200000000000000000000000",
    "00000000000222222222222222222222222220222222222000022222222222222222222222200222222222220022222222222222222222222222000000000000",
    "00000000000222222222222222222222222222222222222000022222222222222222222222222222222222222222222222222222222222222222000000000000",
    "00000000022222222222222222222222222222222222222000022222222222222222222222222222222222222222222222222222222222222222000000000000",
    "00000000022222222222222222222222222222222222222000022222222222222222222222222222222222222222222222222222222222222222000000000000",
    "00000000022222222222222222222222222222222222222000000000000000000000222222222222222222222222222222222222222222222222222000000000",
    "00000000022222222222222222222222222222222222222000000000000000000000222222222222222222222222222222222222222222222222222000000000",
    "00000000000000000000000002222222222220222222222000000000000000000000222222200222222222220222222222222200000000000000000000000000",
    "00000000000000000000000002222222222220222222222000000000000000000000222222200222222222220022222222222200000000000000000000000000",
    "00000000000000000000000002222222220000000222220000000000000000000000000000000222222222220022222222222200000000000000000000000000",
    "00000000000000000000000002222222220022222222222222222222222222222222222222222222222222220022222222222200000000000000000000000000",
    "00000000000000000000000002222222220022222222222222222222222222222222222222222222222222220022222222222200000000000000000000000000",
    "00000000000000000000000000000000000022222222222222222222222222222222222222222222222222220000000000000000000000000000000000000000",
    "00000000000000000000000000000000000022222222222222222222222222222222222222222222222222220000000000000000000000000000000000000000",
    "00000000000000000000000002222222220022222222222222222222222222222222222222222222222222220022222222222200000000000222222000000000",
    "00000000000000000000000002222222220022222222222222222222222222222222222222222222222222220022222222222200000000000222222000000000",
    "00000000000000000000000002222222220022222222222222222222222222222222222222222222222222220022222222222200000000000222222000000000",
    "00000000000000000000000002222222220022222222222222222222222222222222222222222222222222220022222222222200000000000222222000000000",
    "00000000000000000000000002222222220022222222222222222222222222222222222222222222222222220022222222222222222222222222222000000000",
    "00000000022222222222222222222222220022222222222222222222222222222222222222222222222222220022222222222222222222222222222000000000",
    "00000000022222222222222222222222220022222222200000000000000000000000000000000000000000000022222222222222222222222222222000000000",
    "00000000000222222222222222222222222222222222200000000000000000000000000000000000002222222222222222222222222222222200000000000000",
    "00000000000222222222222222222222222222222222200000000000000000000000000000000000002222222222222222222222222222222200000000000000",
    "00000000000222222222222222222222222222222222200000000000000000000000000000000000002222222222222200000022222222222200000000000000",
    "00000000000222222222222222222222222222222222200000000000000000000000000000000000002222222222222200000022222222222200000000000000",
    "00000000000000000000000222222222222222222222200000022222222222222222222222200000002222222222222200000022222222222200000000000000",
    "00000000000000000000000222222222222222222222200000022222222222222222222222200000002222222222222200000022222222222200000000000000",
    "00000000000000000000000222222222220022222222200000022222222222222222222222200000002222222222222200000022222222000200000000000000",
    "00000000000000000000000222222222220022222222200000022222222222222222222222200000002222222222222200000022222222000200000000000000",
    "00000000000000000000000222222222220022222222200000022222222222222222222222200000002222222222222200000022222222000200000000000000",
    "00000000000000000000000222222220000022222222200000022222222222222222222222200000002222222222222200000022222222222220000000000000",
    "00000000000000000000000222222220000022222222200000022222222222222222222222200000002222222222222200000022222222222220000000000000",
    "00000000000000000000000222222220000022222222200000022222222222222222222222222222222222222222222200000022222222222220000000000000",
    "00000000000000000000000222222220000022222222200000022222222220000000000022222222222222222222222200000022222222222200000000000000",
    "00000000000000000000000222222220000022222222200000022222222220000000000022222222222222222222222200000022222222222200000000000000",
    "00000000000222222222222222222220000022222222200000022222222220000000000022222222222222222222222222222222222222222222222000000000",
    "00000000000222222222222222222220000022222222200000022222222220000000000022222222222222222222222222222222222222222222222000000000",
    "00000000000222222222222222222220000022222222200000022222222220000000000022222222222222222222222222222222222222222222222000000000",
    "00000000000222222222222222222220000022222222200000022222222220000000000022222222222222222222222222222222222222222222222000000000",
    "00000000022222222222222222222220000022222222200000022222222222222222222222222222222222222222222222222222222222222222222000000000",
    "00000000022222222222222222222220000022222222200000022222222222222222222222222222222222222222222222222222222222222222222000000000",
    "00000000022222222222222222222220000022222222200000022222222222222222222222222222222222222222222222222222222222222222220000000000",
    "00000000022222222222222222222220000022222222200000022222222222222222222222222222222222222200000000000000000000000222000000000000",
    "00000000022222222222222222222220000022222222200000022222222222222222222222222222222222222200000000000000000000000220000000000000",
    "00000000022222222222222222222220000022222222202222222222222222222222222222222222222222222200000000000000000000000200000000000000",
    "00000000022222222222222222222220000022222222202222222222222222222222222222222222222222222200000000000000000000000200000000000000",
    "00000000000000000000000000000000000022222222222222222222222222222222222222222222222222000000000000000000000000000000000000000000",
    "00000000000000000000000002222222220022222222222222222222222222222222222222222222222000000000000000000000000000000000000000000000",
    "00000000000000000000000002222222220022222222222222222222222222222222222222222222222000000000000000000000000000000000000000000000",
    "00000000000000000000000002222222220022222222222222222222222222222222222222222222222000000000000000000000000000000000000000000000",
    "00000000000000000000000002222222220022222222222222222222222222222222222222222222222000000000000000000000000000000000000000000000",
    "00000000000000000000000002222222220022222222222222222222222222222222222222222222222000000000000000000000000000000000000000000000",
    "00000000022222222222222222222222222222222222222222222222222222222222222222222222222000000000000000000000000000000000000000000000",
    "00000000022222222222222222222222222222222222202222222222222222222222222222222222222000000000000000000000000000000000000000000000",
    "00000000022222222222222222222222222222222222202222222222222222222222222222222222222000000000000000000000000000000000000000000000",
    "00000000022222222222222222222222222222222222200000000000022222222222222222222222222000000000000000000000000000000000000000000000",
    "00000000022222222222222222222222222222222222200000000000022222222222222222222222222000000000000000000000000000000000000000000000",
    "00000000000222222222222222222222220022222222200000000000022222222222222222222222222000000000000000000000000000000000000000000000",
    "00000000000222222222222222222222220022222222200000000000002222222222222222222222222000000000000000000000000000000000000000000000",
    "00000000000222222222222222222222220000222220000000000000000022222000000000000000000000000000000000000000000000000000000000000000",
    "00000000000222222222222222222222220002222222220000000000000222222200000000000000000000000000000000000000000000000000000000000000",
    "00000000000000000000000222222222220002222222220000000000000222222200000000000000000000000000000000000000000000000000000000000000",
    "00000000000000000000000222222222000002222222220000000000000222222200000000000000000000000000000000000000000000000000000000000000",
    "00000000000000000000000222222222000002222222220000000000000222222200000000000000000000000000000000000000000000000000000000000000",
    "00000000000000000000000222222222000002222222220000022222222222222200000000000000000000000000000000000000000000000000000000000000",
    "00000000000000000000000222222222000002222222220000022222222222222200000000000000000000000000000000000000000000000000000000000000",
    "00000000000000000000000222222222000002222222220000022222222222222200000000000000000000000000000000000000000000000000000000000000",
    "00000000000000000000000222222222000002222222220000022222222222222200000000000000000000000000000000000000000000000000000000000000",
    "00000000000000000000000222222222000002222222220000022222222222222200000000000000000000000000000000000000000000000000000000000000",
    "00000000000000000000000222222222000002222222220000022222222222222200000000000000000000000000000000000000000000000000000000000000",
    "00000000000000000000000222222222000002222222220000022222222222222200000000000000000000000000000000000000000000000000000000000000",
    "00000000000222222222222222222222220002222222222222000000222222220000000000000000000000000000000000000000000000000000000000000000",
    "00000000000222222222222222222222220002222222222222000000222222220000000000000000000000000000000000000000000000000000000000000000",
    "00000000000222222222222222222222220002222222222222000000222222220000000000000000000000000000000000000000000000000000000000000000",
    "00000000000222222222222222222222220002222222222222000000222222220000000000000000000000000000000000000000000000000000000000000000",
    "00000000022222222222222222222222220000000222222222000000222222220000000000000000000000000000000000000000000000000000000000000000",
    "00000000022222222222222222222222220000000222222222000000222222220000000000000000000000000000000000000000000000000000000000000000",
    "00000000022222222222222222222222220000000222222222000000222222220000000000000000000000000000000000000000000000000000000000000000",
    "00000000022222222222222222222222220000000222222222000000222222220000000000000000000000000000000000000000000000000000000000000000",
    "00000000002222222222222222222222220000000222222222000000222222220000000000000000000000000000000000000000000000000000000000000000",
    "00000000000222222222222222222222220000000222222222000000222222220000000000000000000000000000000000000000000000000000000000000000",
    "00000000000222222222222222222222220000000222222222000000222222220000000000000000000000000000000000000000000000000000000000000000",
    "00000000000002222222222222222222220000000222220000000000222222220000000000000000000000000000000000000000000000000000000000000000",
    "00000000000000222220000000000000000000000222220000000000000000000000000000000000000000000000000000000000000000000000000000000000",
    "00000000000000022220000000000000000000000222222222000000000000000000000000000000000000000000000000000000000000000000000000000000",
    "00000000000000002220000000000000000000000222222222000000000000000000000000000000000000000000000000000000000000000000000000000000",
    "00000000000000000220000000000000000000000222222222000000000000000000000000000000000000000000000000000000000000000000000000000000",
    "00000000000000000000000000000000000000000000000000000000000000000000000000000000000000000000000000000000000000000000000000000000",
    "00000000000000000000000000000000000000000000000000000000000000000000000000000000000000000000000000000000000000000000000000000000",
    "00000000000000000000000000000000000000000000000000000000000000000000000000000000000000000000000000000000000000000000000000000000",
    "00000000000000000000000000000000000000000000000000000000000000000000000000000000000000000000000000000000000000000000000000000000",
    "00000000000000000000000000000000000000000000000000000000000000000000000000000000000000000000000000000000000000000000000000000000",
    "00000000000000000000000000000000000000000000000000000000000000000000000000000000000000000000000000000000000000000000000000000000",
    "00000000000000000000000000000000000000000000000000000000000000000000000000000000000000000000000000000000000000000000000000000000",
    "00000000000000000000000000000000000000000000000000000000000000000000000000000000000000000000000000000000000000000000000000000000",
    "00000000000000000000000000000000000000000000000000000000000000000000000000000000000000000000000000000000000000000000000000000000",
    "00000000000000000000000000000000000000000000000000000000000000000000000000000000000000000000000000000000000000000000000000000000"
  ],
  "agent_spawn_pool": [
    [80, 16],
    [50, 80],
    [20, 105],
    [37, 35]
  ],
  "npc_spawn_pool": [
    [20, 10],
    [112, 16],
    [62, 113],
    [102, 62]
  ],
  "station_pool": [{"x": 37, "z": 42, "dx": 3, "dz": 3}, {"x": 86, "z": 49, "dx": 3, "dz": 3}, {"x": 32, "z": 79, "dx": 3, "dz": 3}, {"x": 81, "z": 88, "dx": 3, "dz": 3}],
  "max_battery": 200,
  "max_steps": 1000,
  "hero_id": 37,
  "npc_ids": null,
  "local_view_size": 21
}
