{
  "schema_version": 1,
  "map_id": 2,
  "size": [128, 128],
  "custom_map": [
    "00000000000000000000000000000000000000000000000000000000000000000000000000000000000000000000000000000000000000000000000000000000",
    "02222222222222222222222222222222222222222222222222222222222222222222222222222222222222222222222222222222222222222222222222222220",
    "02222222222222222222222222222222222222222222222222222222222222222222222222222222222222222222222222222222222222222222222222222220",
    "02222222222222222222222222222222222222222222222222222222222222222222222222222222222222222222222222222222222222222222222222222220",
    "02222222222222222222222222222222222222222222222222222222222222222222222222222222222222222222222222222222222222222222222222222220",
    "02222000000000020222000000000020222000000000020222000000000020222000000000020222000000000020222000000000020222000000000020222000",
    "02222000000000020222000000000020222000000000020222000000000020222000000000020222000000000020222000000000020222000000000020222000",
    "02222000000000020222000000000020222000000000020222000000000020222000000000020222000000000020222000000000020222000000000020222000",
    "02222000000000020222000000000020222000000000020222000000000020222000000000020222000000000020222000000000020222000000000020222000",
    "02222000000000020222000000000020222000000000020222000000000020222000000000020222000000000020222000000000020222000000000020222000",
    "02222000000000020222000000000020222000000000020222000000000020222000000000020222000000000020222000000000020222000000000020222000",
    "02222000000000020222000000000020222000000000020222000000000020222000000000020222000000000020222000000000020222000000000020222000",
    "02222000000000020222000000000020222000000000020222000000000020222000000000020222000000000020222000000000020222000000000020222000",
    "02222000000000020222000000000020222000000000020222000000000020222000000000020222000000000020222000000000020222000000000020222000",
    "02222000000000020222000000000020222000000000020222000000000020222000000000020222000000000020222000000000020222000000000020222000",
    "02222222222222222222222222222222222222222222222222222222222222222222222222222222222222222222222222222222222222222222222222222220",
    "02222000000000020222000000000020222000000000020222000000000020222000000000020222000000000020222000000000020222000000000020222000",
    "02222222222222222222222222222222222222222222222222222222222222222222222222222222222222222222222222222222222222222222222222222220",
    "02222222222222222222222222222222222222222222222222222222222222222222222222222222222222222222222222222222222222222222222222222220",
    "02222222222222222222222222222222222222222222222222222222222222222222222222222222222222222222222222222222222222222222222222222220",
    "02222000000000020222000000000020222000000000020222000000000020222000000000020222000000000020222000000000020222000000000020222000",
    "02222000000000020222000000000020222000000000020222000000000020222000000000020222000000000020222000000000020222000000000020222000",
    "02222000000000020222000000000020222000000000020222000000000020222000000000020222000000000020222000000000020222000000000020222000",
    "02222000000000020222000000000020222000000000020222000000000020222000000000020222000000000020222000000000020222000000000020222000",
    "02222000000000020222000000000020222000000000020222000000000020222000000000020222000000000020222000000000020222000000000020222000",
    "02222000000000020222000000000020222000000000020222000000000020222000000000020222000000000020222000000000020222000000000020222000",
    "02222000000000020222000000000020222000000000020222000000000020222000000000020222000000000020222000000000020222000000000020222000",
    "02222000000000020222000000000020222000000000020222000000000020222000000000020222000000000020222000000000020222000000000020222000",
    "02222000000000020222000000000020222000000000020222000000000020222000000000020222000000000020222000000000020222000000000020222000",
    "02222000000000020222000000000020222000000000020222000000000020222000000000020222000000000020222000000000020222000000000020222000",
    "02222222222222222222222222222222222222222222222222222222222222222222222222222222222222222222222222222222222222222222222222222220",
    "02222000000000020222000000000020222000000000020222000000000020222000000000020222000000000020222000000000020222000000000020222000",
    "02222222222222222222222222222222222222222222222222222222222222222222222222222222222222222222222222222222222222222222222222222220",
    "02222222222222222222222222222222222222222222222222222222222222222222222222222222222222222222222222222222222222222222222222222220",
    "02222222222222222222222222222222222222222222222222222222222222222222222222222222222222222222222222222222222222222222222222222220",
    "02222000000000020222000000000020222000000000020222000000000020222000000000020222000000000020222000000000020222000000000020222000",
    "02222000000000020222000000000020222000000000020222000000000020222000000000020222000000000020222000000000020222000000000020222000",
    "02222000000000020222000000000020222000000000020222000000000020222000000000020222000000000020222000000000020222000000000020222000",
    "02222000000000020222000000000020222000000000020222000000000020222000000000020222000000000020222000000000020222000000000020222000",
    "02222000000000020222000000000020222000000000020222000000000020222000000000020222000000000020222000000000020222000000000020222000",
    "02222000000000020222000000000020222000000000020222000000000020222000000000020222000000000020222000000000020222000000000020222000",
    "02222000000000020222000000000020222000000000020222000000000020222000000000020222000000000020222000000000020222000000000020222000",
    "02222000000000020222000000000020222000000000020222000000000020222000000000020222000000000020222000000000020222000000000020222000",
    "02222000000000020222000000000020222000000000020222000000000020222000000000020222000000000020222000000000020222000000000020222000",
    "02222000000000020222000000000020222000000000020222000000000020222000000000020222000000000020222000000000020222000000000020222000",
    "02222222222222222222222222222222222222222222222222222222222222222222222222222222222222222222222222222222222222222222222222222220",
    "02222000000000020222000000000020222000000000020222000000000020222000000000020222000000000020222000000000020222000000000020222000",
    "02222222222222222222222222222222222222222222222222222222222222222222222222222222222222222222222222222222222222222222222222222220",
    "02222222222222222222222222222222222222222222222222222222222222222222222222222222222222222222222222222222222222222222222222222220",
    "02222222222222222222222222222222222222222222222222222222222222222222222222222222222222222222222222222222222222222222222222222220",
    "02222000000000020222000000000020222000000000020222000000000020222000000000020222000000000020222000000000020222000000000020222000",
    "02222000000000020222000000000020222000000000020222000000000020222000000000020222000000000020222000000000020222000000000020222000",
    "02222000000000020222000000000020222000000000020222000000000020222000000000020222000000000020222000000000020222000000000020222000",
    "02222000000000020222000000000020222000000000020222000000000020222000000000020222000000000020222000000000020222000000000020222000",
    "02222000000000020222000000000020222000000000020222000000000020222000000000020222000000000020222000000000020222000000000020222000",
    "02222000000000020222000000000020222000000000020222000000000020222000000000020222000000000020222000000000020222000000000020222000",
    "02222000000000020222000000000020222000000000020222000000000020222000000000020222000000000020222000000000020222000000000020222000",
    "02222000000000020222000000000020222000000000020222000000000020222000000000020222000000000020222000000000020222000000000020222000",
    "02222000000000020222000000000020222000000000020222000000000020222000000000020222000000000020222000000000020222000000000020222000",
    "02222000000000020222000000000020222000000000020222000000000020222000000000020222000000000020222000000000020222000000000020222000",
    "02222222222222222222222222222222222222222222222222222222222222222222222222222222222222222222222222222222222222222222222222222220",
    "02222000000000020222000000000020222000000000020222000000000020222000000000020222000000000020222000000000020222000000000020222000",
    "02222222222222222222222222222222222222222222222222222222222222222222222222222222222222222222222222222222222222222222222222222220",
    "02222222222222222222222222222222222222222222222222222222222222222222222222222222222222222222222222222222222222222222222222222220",
    "02222222222222222222222222222222222222222222222222222222222222222222222222222222222222222222222222222222222222222222222222222220",
    "02222000000000020222000000000020222000000000020222000000000020222000000000020222000000000020222000000000020222000000000020222000",
    "02222000000000020222000000000020222000000000020222000000000020222000000000020222000000000020222000000000020222000000000020222000",
    "02222000000000020222000000000020222000000000020222000000000020222000000000020222000000000020222000000000020222000000000020222000",
    "02222000000000020222000000000020222000000000020222000000000020222000000000020222000000000020222000000000020222000000000020222000",
    "02222000000000020222000000000020222000000000020222000000000020222000000000020222000000000020222000000000020222000000000020222000",
    "02222000000000020222000000000020222000000000020222000000000020222000000000020222000000000020222000000000020222000000000020222000",
    "02222000000000020222000000000020222000000000020222000000000020222000000000020222000000000020222000000000020222000000000020222000",
    "02222000000000020222000000000020222000000000020222000000000020222000000000020222000000000020222000000000020222000000000020222000",
    "02222000000000020222000000000020222000000000020222000000000020222000000000020222000000000020222000000000020222000000000020222000",
    "02222000000000020222000000000020222000000000020222000000000020222000000000020222000000000020222000000000020222000000000020222000",
    "02222222222222222222222222222222222222222222222222222222222222222222222222222222222222222222222222222222222222222222222222222220",
    "02222000000000020222000000000020222000000000020222000000000020222000000000020222000000000020222000000000020222000000000020222000",
    "02222222222222222222222222222222222222222222222222222222222222222222222222222222222222222222222222222222222222222222222222222220",
    "02222222222222222222222222222222222222222222222222222222222222222222222222222222222222222222222222222222222222222222222222222220",
    "02222222222222222222222222222222222222222222222222222222222222222222222222222222222222222222222222222222222222222222222222222220",
    "02222000000000020222000000000020222000000000020222000000000020222000000000020222000000000020222000000000020222000000000020222000",
    "02222000000000020222000000000020222000000000020222000000000020222000000000020222000000000020222000000000020222000000000020222000",
    "02222000000000020222000000000020222000000000020222000000000020222000000000020222000000000020222000000000020222000000000020222000",
    "02222000000000020222000000000020222000000000020222000000000020222000000000020222000000000020222000000000020222000000000020222000",
    "02222000000000020222000000000020222000000000020222000000000020222000000000020222000000000020222000000000020222000000000020222000",
    "02222000000000020222000000000020222000000000020222000000000020222000000000020222000000000020222000000000020222000000000020222000",
    "02222000000000020222000000000020222000000000020222000000000020222000000000020222000000000020222000000000020222000000000020222000",
    "02222000000000020222000000000020222000000000020222000000000020222000000000020222000000000020222000000000020222000000000020222000",
    "02222000000000020222000000000020222000000000020222000000000020222000000000020222000000000020222000000000020222000000000020222000",
    "02222000000000020222000000000020222000000000020222000000000020222000000000020222000000000020222000000000020222000000000020222000",
    "02222222222222222222222222222222222222222222222222222222222222222222222222222222222222222222222222222222222222222222222222222220",
    "02222000000000020222000000000020222000000000020222000000000020222000000000020222000000000020222000000000020222000000000020222000",
    "02222222222222222222222222222222222222222222222222222222222222222222222222222222222222222222222222222222222222222222222222222220",
    "02222222222222222222222222222222222222222222222222222222222222222222222222222222222222222222222222222222222222222222222222222220",
    "02222222222222222222222222222222222222222222222222222222222222222222222222222222222222222222222222222222222222222222222222222220",
    "02222000000000020222000000000020222000000000020222000000000020222000000000020222000000000020222000000000020222000000000020222000",
    "02222000000000020222000000000020222000000000020222000000000020222000000000020222000000000020222000000000020222000000000020222000",
    "02222000000000020222000000000020222000000000020222000000000020222000000000020222000000000020222000000000020222000000000020222000",
    "02222000000000020222000000000020222000000000020222000000000020222000000000020222000000000020222000000000020222000000000020222000",
    "02222000000000020222000000000020222000000000020222000000000020222000000000020222000000000020222000000000020222000000000020222000",
    "02222000000000020222000000000020222000000000020222000000000020222000000000020222000000000020222000000000020222000000000020222000",
    "02222000000000020222000000000020222000000000020222000000000020222000000000020222000000000020222000000000020222000000000020222000",
    "02222000000000020222000000000020222000000000020222000000000020222000000000020222000000000020222000000000020222000000000020222000",
    "02222000000000020222000000000020222000000000020222000000000020222000000000020222000000000020222000000000020222000000000020222000",
    "02222000000000020222000000000020222000000000020222000000000020222000000000020222000000000020222000000000020222000000000020222000",
    "02222222222222222222222222222222222222222222222222222222222222222222222222222222222222222222222222222222222222222222222222222220",
    "02222000000000020222000000000020222000000000020222000000000020222000000000020222000000000020222000000000020222000000000020222000",
    "02222222222222222222222222222222222222222222222222222222222222222222222222222222222222222222222222222222222222222222222222222220",
    "02222222222222222222222222222222222222222222222222222222222222222222222222222222222222222222222222222222222222222222222222222220",
    "02222222222222222222222222222222222222222222222222222222222222222222222222222222222222222222222222222222222222222222222222222220",
    "02222000000000020222000000000020222000000000020222000000000020222000000000020222000000000020222000000000020222000000000020222000",
    "02222000000000020222000000000020222000000000020222000000000020222000000000020222000000000020222000000000020222000000000020222000",
    "02222000000000020222000000000020222000000000020222000000000020222000000000020222000000000020222000000000020222000000000020222000",
    "02222000000000020222000000000020222000000000020222000000000020222000000000020222000000000020222000000000020222000000000020222000",
    "02222000000000020222000000000020222000000000020222000000000020222000000000020222000000000020222000000000020222000000000020222000",
    "02222000000000020222000000000020222000000000020222000000000020222000000000020222000000000020222000000000020222000000000020222000",
    "02222000000000020222000000000020222000000000020222000000000020222000000000020222000000000020222000000000020222000000000020222000",
    "02222000000000020222000000000020222000000000020222000000000020222000000000020222000000000020222000000000020222000000000020222000",
    "02222000000000020222000000000020222000000000020222000000000020222000000000020222000000000020222000000000020222000000000020222000",
    "02222000000000020222000000000020222000000000020222000000000020222000000000020222000000000020222000000000020222000000000020222000",
    "02222222222222222222222222222222222222222222222222222222222222222222222222222222222222222222222222222222222222222222222222222220",
    "02222000000000020222000000000020222000000000020222000000000020222000000000020222000000000020222000000000020222000000000020222000",
    "02222222222222222222222222222222222222222222222222222222222222222222222222222222222222222222222222222222222222222222222222222220",
    "02222222222222222222222222222222222222222222222222222222222222222222222222222222222222222222222222222222222222222222222222222220",
    "02222222222222222222222222222222222222222222222222222222222222222222222222222222222222222222222222222222222222222222222222222220",
    "02222000000000020222000000000020222000000000020222000000000020222000000000020222000000000020222000000000020222000000000020222000",
    "02222000000000020222000000000020222000000000020222000000000020222000000000020222000000000020222000000000020222000000000020222000",
    "00000000000000000000000000000000000000000000000000000000000000000000000000000000000000000000000000000000000000000000000000000000"
  ],
  "agent_spawn_pool": [
    [2, 2],
    [2, 125],
    [125, 2],
    [62, 62],
    [62, 77],
    [77, 62]
  ],
  "npc_spawn_pool": [
    [18, 64],
    [34, 64],
    [49, 64],
    [64, 34],
    [64, 49],
    [64, 94],
    [79, 64],
    [94, 64]
  ],
  "station_pool": [{"x": 2, "z": 2, "dx": 3, "dz": 3}, {"x": 123, "z": 2, "dx": 3, "dz": 3}, {"x": 2, "z": 123, "dx": 3, "dz": 3}, {"x": 123, "z": 123, "dx": 3, "dz": 3}],
  "max_battery": 200,
  "max_steps": 1000,
  "hero_id": 37,
  "npc_ids": null,
  "local_view_size": 21
}
