{
  "schema_version": 1,
  "map_id": 5,
  "size": [128, 128],
  "custom_map": [
    "00000000000000000000000000000000000000000000000000000000000000000000000000000000000000000000000000000000000000000000000000000000",
    "00000000000000000000000000000000000000000000000000000000000000000000000000000000000000000000000000000000000000000000000000000000",
    "00000000002222222000000000000000000000000000000000000000000000000000000000000000000000000000000000000000000000000000000000000000",
    "00000000002222222000000000000000000000000000000000000000000000000000000000000000000000000000000000000000000000000000000000000000",
    "00000000002222222000000000000000000000000000000000000000000000000000000000000000000000000000000000022222222222222222000000000000",
    "00000000002222222000000000000000000000000000000000000000000000000000000000000000000000000000000000022222222222222222220000000000",
    "00000000002222222000000000000000000000000000000000000000000000000000000000000000000000000000000000022222222222222222220000000000",
    "00000000002222222000000000000000000000000000000000000000000000000000000000000000000000000000000000022222222222222222220000000000",
    "00000000002222222000000000000000000000000000000000000000000000000000000000000000000000000000000000022222222222222222220000000000",
    "00000000002222222000000000000000000000000000000000000000000000000000000000000000000000000000000000022222222222222222220000000000",
    "00000000002222222222222222222220000000000000000000000000000000000000000000000000000000000000000000022222222222222222220000000000",
    "00000000002222222222222222222220000000000000000000000000000000000000000000000000000000000000000000022222222222222222220000000000",
    "00000000002222222222222222222222000000000000000000000000000000000000000000000000000000000000000000022222222222222222220000000000",
    "00000000002222222222222222222222000000000000000000000000000000000000000000000222222222222222222222222222222222222222220000000000",
    "00000000002222222222222222222222002222220000000000000000000000000000000000000222222222222222222222222222222222222222220000000000",
    "00000000002222222222222222222222222222220000000000000000000000000000000000000022222222222222222222222222222222222222220000000000",
    "00000000002222222222222222222222222222220000000000000000000000000000000000000022222222222222222222222222222222222222220000000000",
    "00000000002222222222222222222222222222220000000000000000000000000000000000000022222222222222222222222222222222222222220000000000",
    "00000000002222222222222222222222222222222002000002222000020000000000000000000022222222222222222222222222222222222222220000000000",
    "00000000002222222222222222222222222222222222222222222222222220000000000222222222222222222222222222222222222222222222220000000000",
    "00000000002222222222222222222222222222222222222222222222222220000000000222222222222222222222222222222222222222222222222000000000",
    "00000000002222222222222222222222222222222222222222222222222220000000000222222222222222222222222222222222222222222222222000000000",
    "00000000002222222222222222222222222222222222222222222222222220000000000222222222222222222222222222222222222222222222220000000000",
    "00000000002222222222222222222222222222222222222222222222222220000000000222222222222222222222222222222222222222222222220000000000",
    "00000000002222222222222222222222222222222222222222222222222220000000000222222222222222222222222222222222222222222222220000000000",
    "00000000002222222222222222222222222222222222222222222222222220000000002222222222222222222222222222222222222222222222220000000000",
    "00000000002222222222222222222222222222222222222222222222222222222222222222222222222222222222222222222222222222222222220000000000",
    "00000000002222222222222222222222222222222222222222222222222222222222222222222222222222222222222222222222222222222222222220000000",
    "00000000002222222222222222222222222222222222222222222222222222222222222222222222222222222222222222222222222222222222222220000000",
    "00000000002222222222222222222222222222222222222222222222222222222222222222222222222222222222222222222222222222222222222220000000",
    "00000000002222222222222222222222222222222222222222222222222222222222222222222222222222222222222222222222222222222222222220000000",
    "00000000002222222222222222222222222222222222222222222222222222222222222222222222222222222222222222222222222222222222222220000000",
    "00000000002222222222222222222222222222222222222222222222222222222222222222222222222222222222222222222222222222222222222220000000",
    "00000000002222222222222222222222222222222222222222222222222222222222222222222222222222222222222222222222222222222222222220000000",
    "00000000002222222222222222222222000000000000000000002222222222222222222222222222222222222222222222222222222222222222222220000000",
    "00000000002222222222222222222222000000000000000000002222222222222222222222222222222222222222222222222222222222222222222220000000",
    "00000000002222222222222222222222000000000000000000002222222222000000000000000022222220000000000000000000022222222222222220000000",
    "00000000002222222222222222222222000000000000000000002222222222000000000000000222222220000000000000000000022222222222222220000000",
    "00000000002222222222222222222220000000000000000000002222222222000000000000000222222220000000000000000000022222222222222220000000",
    "00000000002222222222222222222200000000000000000000002222222222000000000000000222222220000000000000000000022222222222222220000000",
    "00000000002222222222222222222200000000000000000000002222222222200000000000000222222220000000000000000000022222222222222220000000",
    "00000000000022222222222222222000000000000000000000002222222222200000000000000222222220000000000000000000222222222222222220000000",
    "00000000000022222222222222220000000000000000000000002222222222200000000000000222222220000000000000000000222222222222200000000000",
    "00000000000022222222222222200000000000000000000000002222222222000000000000000222222220000000000000000000222222222222200000000000",
    "00000000000022222222222222200000000000000000000000002222222222000000000000000222222220000000000000000000222222222222000000000000",
    "00000000000022222222222222200000000000000000000000002222222222000000000000000222222220000000000000000000222222222222000000000000",
    "00000000000022222222222222000000000000000000000000002222222222222222222222222222222220000000000000000000222222222222000000000000",
    "00000000000022222200000000000000000000000000000000002222222222222222222222222222222220000000000000000000222222222222000000000000",
    "00000000000022222200000000000000000222222222222222222222222222222222222222222222222220000000000000000000022222222222000000000000",
    "00000000000022222200000000000000000222222222222222222222222222222222222222222222222220000000000000000000022222222222000000000000",
    "00000000000022222200000000000000000222222222222222222222222222222222222222222222222220000000000000000000022222222222000000000000",
    "00000000000022222222222000000000000222222222222222222222222222222222222222222222222220000000000000000000022222222222000000000000",
    "00000000222222222222222200000000000222222222222222222222222222222222222222222222222220000000000000000000022222222222000000000000",
    "00000000222222222222222200000000000222222222222222222222222222222222222222222222222220000000000000000000022222222222000000000000",
    "00000000222222222222222222222222222222222222222222222222222222222222200000000000000000000000000000000000022222222222000000000000",
    "00000000222222222222222222222222222222222200000000000002222222222222000000000000000000000000000000000002222222222222000000000000",
    "00000000222222222222222222222222222222222200000000000002222222222220000000000000000000000000000000000002222222222222000000000000",
    "00000000222222222222222222222222222222222200000000000002222222222220000000000000000000022222222222222222222222222222000000000000",
    "00000000222222222222222222222222222222222200000000000002222222222220000000000000000022222222222222222222222222222222000000000000",
    "00000000222222222222222222222222222222222000000000000002222222222220000000000000000022222222222222222222222222222222000000000000",
    "00000000222222222222222222222222222222222000000000000022222222222220000000000000000022222222222222222222222222222222000000000000",
    "00000000222222222222222222222222222222220000000000000022222222222220000000000000000022222222222222222222222222222222000000000000",
    "00000000222222222222222222222222222222200000000000000022222222222220000000000000000022222222222222222222222222222222222220000000",
    "00000000022222222222222222220000000000000000000000000022222222222220000000000000000022222222222222222222222222222222222220000000",
    "00000000000000000022222222220000000000000000000000000022222222222220000000000000000022222222222222222222222222222222222220000000",
    "00000000000000000000022222220000000000000000000000000022222222222220000000000000000022222222222222222222222222222222222220000000",
    "00000000000000000000022222220000000000000000000000000022222222222220000000000000000022222222222222222222222222222222222220000000",
    "00000000000000000000022222220000000000000000000000000002222222222220000000000000000022222222222222222222222222222222222220000000",
    "00000000000000000000022222220000000000000000000000000002222222222220000000000000000022222222222222222222222222222222222220000000",
    "00000000000000000000022222220000000000000000000000000002222222222220000000000000000022222222222222222222222222222222222220000000",
    "00000000000000000000022222220000000000000000000000000002222222222220000000000000000022222222222222222222222222222222222220000000",
    "00000000000000000000022222222200000000000000000000002222222222222220000000000000000022222222000002222222222222222222222220000000",
    "00000000000000022222222222222220000000000000000000002222222222222220000000000000000022222222000002222222222222222222222220000000",
    "00000000000000022222222222222220000000000000000000002222222222222220000000000000000022222222000002222222222222222222222220000000",
    "00000000000022222222222222222222200000000000000000002222222222222220000000000000000022222222000002222222222222222222222220000000",
    "00000000000222222222222222222222220000000000000000002222222222222220000000000000000022222222000002222222222222222222222220000000",
    "00000000000222222222222222222222220000000000000000002222222222222220000000000000000022222222000002222222222222222222222220000000",
    "00000000000222222222222222222222220000000000000002222222222222222222000000000000000022222222000002222222222222222222222220000000",
    "00000000000222222222222222222222220000000000000002222222222222222222222222222222222222222222000002222222222222222222222220000000",
    "00000000000222222222222222222222220000000000000002222222222222222222222222222222222222222222000002222222222222222222222220000000",
    "00000000000222222222222222222222220000000000000002222222222222222222222222222222222222222222000002222222222222222222222220000000",
    "00000000000222222222222222222222222000000000000002222222222222222222222222222222222222222222000002222222222222222222222220000000",
    "00000000000222222222222222222222222000000000000000222222222222222222222222222222222222222222000002222222222222222222222220000000",
    "00000000000222222222222222222222222000000000000000222222222222222222222222222222222222222222000002222222222222222222222220000000",
    "00000000000222222222222222222222222000000000000000222222222220000000000022222222222222222222000002222222222222222222000000000000",
    "00000000000222222222222222222222222000000000000000222222222200000000000002222222222222222222000002222222222222222222000000000000",
    "00000000000222222222222222222222222000000000000000022222222200000000000002222222222222222222000000000000202222222222000000000000",
    "00000000000222222222222222222222222000000000000000000002222200000000000002222222222222222222000000000000000222222220000000000000",
    "00000000000022222222222222222222222000000000000000000002222200000000000002222222222222222222000000000000000022222200000000000000",
    "00000000000022222222222222222222222000000000000000000002222200000000000002222222222222222222000000000000000022222200000000000000",
    "00000000000022222222222222222222222000000000000000000002222200000000000002222222222222222222000000000000000022222200000000000000",
    "00000000000022222222222222222222000000000000000000000002222200000000000002222222222222222222000000000000000022222200000000000000",
    "00000000000022222222222222222220000000000000000000000002222200000000000002222222222222222222000000000000000022222200000000000000",
    "00000000000022222222222222222220000000000000000000000002222200000000000002222222222222222222000000000000000022222200000000000000",
    "00000000000022222222222222222220000000000000000000000002222200000000000002222222222222222222000000000000000022222200000000000000",
    "00000000000222222222222222222220000000000000000000000002222200000000000002222222222222222222000000000000000022222200000000000000",
    "00000000000222222222222222222220000002222220000000000002222200000000000002222222222222222222000000000000000022222200000000000000",
    "00000000000222222222222222222220000002222222000000000002222200000000000002222222222222222222000000000000000022222200000000000000",
    "00000000000222222222222222222222200002222222000000000002222200000000000002222222222222222222000000000000000022222200000000000000",
    "00000000000222222222222222222222222222222222000000000002222200000000000002222222222222222222000000000000000022222200000000000000",
    "00000000000222222222222222222222222222222222000000000002222200000000000002222222222222222222000000000000000022222200000000000000",
    "00000000000222222222222222222222222222222222000000000002222200000000000002222222222222222222200000000000000022222200000000000000",
    "00000000000222222222222222222222222222222222000000000002222200000000000022222222222222222222200000000000000022222200000000000000",
    "00000000000222222222222222222222222222222222000000000002222220000000000022222222200000222222000000000000000022222200000000000000",
    "00000000000222222222222222222222222222222222000000000002222222222222200222222222200000000000000000000000000022222200000000000000",
    "00000000000222222222222222222222222222222222000000000002222222222222222222222222200000000000000000000000000022222200000000000000",
    "00000000002222222222222222222222222222222222000000000002222222222222222222222222200000000000000000000000000022222200000000000000",
    "00000000022222222222222222222222222222222222000000000002222222222222222222222222200000000000000000000000000022222200000000000000",
    "00000000222222222222222222222222222222222220000000000002222222222222222222222222200000000000000000000000000022222200000000000000",
    "00000002222222222222222222222222222222222222200000222222222222222222222222222222222000000000000000000000000022222200000000000000",
    "00000002222222222222222222222222222222222222222222222222222222222222222222222222222000000000000000000000000022222200000000000000",
    "00000002222222222222222222222222222222222222222222222222222222222222222222222222222000000000000000000000000022222200000000000000",
    "00000002222222222222222222222222222222222222222222222222222222222222222222222222222222222222222222222222222222222200000000000000",
    "00000002222222222222222222222222222222222222222222222222222222222222222222222222222222222222222222222222222222222200000000000000",
    "00000002222222222222222222222222222222222222222222222222222222222222222222222222222222222222222222222222222222222200000000000000",
    "00000002222222222222222222222222222222222222222222222222222222222222222222222222222222222222222222222222222222222000000000000000",
    "00000002222222222222222222222222222222222222222222222222222222222222222222222222222200000000000000000000000000000000000000000000",
    "00000002222222222222222222222222222222222222222222222222222222222222222222222222222200000000000000000000000000000000000000000000",
    "00000002222222222222222222222222222222222222222222222222222222222222222222222222222200000000000000000000000000000000000000000000",
    "00000002222222222222222222222222222222222222222222222222222222222222222222222222222200000000000000000000000000000000000000000000",
    "00000002222222222222222222222222222222222222222222222222222222222222222222222222222000000000000000000000000000000000000000000000",
    "00000002222222222222222222222222222222222222222222222222222222222222222222220000000000000000000000000000000000000000000000000000",
    "00000000000000000002222222222222222222222000000000000000000002222222222222220000000000000000000000000000000000000000000000000000",
    "00000000000000000000000000000000000000000000000000000000000000000000000000000000000000000000000000000000000000000000000000000000",
    "00000000000000000000000000000000000000000000000000000000000000000000000000000000000000000000000000000000000000000000000000000000",
    "00000000000000000000000000000000000000000000000000000000000000000000000000000000000000000000000000000000000000000000000000000000",
    "00000000000000000000000000000000000000000000000000000000000000000000000000000000000000000000000000000000000000000000000000000000",
    "00000000000000000000000000000000000000000000000000000000000000000000000000000000000000000000000000000000000000000000000000000000"
  ],
  "agent_spawn_pool": [
    [103, 30],
    [15, 36],
    [88, 60],
    [70, 116]
  ],
  "npc_spawn_pool": [
    [80, 16],
    [56, 81],
    [111, 84],
    [18, 111]
  ],
  "station_pool": [{"x": 19, "z": 10, "dx": 3, "dz": 3}, {"x": 113, "z": 55, "dx": 3, "dz": 3}, {"x": 55, "z": 57, "dx": 3, "dz": 3}, {"x": 40, "z": 107, "dx": 3, "dz": 3}],
  "max_battery": 200,
  "max_steps": 1000,
  "hero_id": 37,
  "npc_ids": null,
  "local_view_size": 21
}
