{
  "schema_version": 1,
  "map_id": 4,
  "size": [128, 128],
  "custom_map": [
    "00000000000000000000000000000000000000000000000000000000000000000000000000000000000000000000000000000000000000000000000000000000",
    "00000000000000000000000000000000000000000000000000000000000000000000000000000000000000000000000000000000000000000000000000000000",
    "00000000000000000000000000000000000000000000000000000000000000000000000000000000000000000000000000000000000000000000000000000000",
    "00000002222222222222222222222222222222222222222222222222222222222222222222222222222222222222222222222222222222222222000000000000",
    "00000002222222222222222222222222222222222222222222222222222222222222222222222222222222222222222222222222222222222222000000000000",
    "00000002222222222222222222222222222222222222222222222222222222222222222222222222222222222222222222222222222222222222000000000000",
    "00000002222222222222222222222222222222222222222222222222222222222222222222222222222222222222222222222222222222222222000000000000",
    "00022222222222222222222222222222222222222222222222222222222222222222222222222222222222222222222222222222222222222222000000000000",
    "00022222222222222222222222222222222222222222222222222222222222222222222222222222222222222222222222222222222222222222000000000000",
    "00022222222222222222222222222222222222222222222222222222222222222222222222222222222222222222222222222222222222222222000000000000",
    "00022222222000000000000000000000000000000000000000000000222200000000000000000000000000000000000000000000000000022222000000000000",
    "00022222222000000000000000000000000000000000000000000000222200000000000000000000000000000000000000000000000000022222000000000000",
    "00022222222002222222222222222222222222222222222222222222222222222222222222222222222222222222222222222000222222222222222222220000",
    "00022222222002222222222222222222222222222222222222222222222222222222222222222222222222222222222222222000222222222222222222220000",
    "00022222222002222222222222222222222222222222222222222222222222222222222222222222222222222222222222222000222222222222222222220000",
    "00022222222002222222222222222222222222222222222222222222222222222222222222222222222222222222222222222222222222222222222222220000",
    "00022222222002222222222222222222222222222222222222222222222222222222222222222222222222222222222222222222222222222222222222220000",
    "00022222222222222222222222222222222222222222222222222222222222222222222222222222222222222222222222222222222222222222222222220000",
    "00022222222222222222222222222222222222222222222222222222222222222222222222222222222222222222222222222222222222222222222222220000",
    "00022222222222222222222222222222222222222222222222222222222222222222222222222222222222222222222222222222222222222222222222220000",
    "00022222222222222222222222222222222222222222222222222222222222222222222222222222222222222222222222222222222222222222222222220000",
    "00022222222222222222222222222222222222222222222222222222222222222222222222222222222222222222222222222222222222222222222222220000",
    "00022222222222222222222222222222222222222222222222222222222222222222222222222222222222222222222222222222222222222222222222220000",
    "00022222222222222222222222222222222222222222222222222222222222222222222222222222222222222222222222222222222222222222222222220000",
    "00022222222222222222222222222222222222222222222222222222222222222222222222222222222222222222222222222000222222222222222222220000",
    "00022222222222222222222222222222222222222222222222222222222222222222222222222222222222222222222222222000222222222222222222220000",
    "00022222222222222222222222222222222222222222222222222222222222222222222222222222222222222222222222222000222222222222222222220000",
    "00022222222222222222222222222222222222222222222222222222222222222222222222222222222222222222222222222000222222222222222222220000",
    "00022222222222222222222200000000000022222222222222000000000000000000000000000000000000000000000000000000000022222220000000000000",
    "00022222222000000222222200000000000022222222222222000000000000000000000000000000000000000000000000000000000022222220000000000000",
    "00022222222000000222222200000000000022222222222222000000000000000000000000000000000000000000000000000000000022222220000000000000",
    "00022222222000000222222200000000000022222222222222000000000000000000000000000000000000000000000000000000000022222220000000000000",
    "00022222222000000222222200000000000022222222222222000000000000000000000000000000000000000000000000000000000022222220000000000000",
    "00022222222000000222222200000000000022222222222222000000000000000000000000000000000000000000000000000000000022222220000000000000",
    "00022222222000000222222200000000000222222222222222222222222222222222222222222222222222222222222222222222222222222222222222222220",
    "00022222222000000222222200000000002222222222222222222222222222222222222222222222222222222222222222222222222222222222222222222220",
    "00022222222000000222222200000000002222222222222222222222222222222222222222222222222222222222222222222222222222222222222222222220",
    "00022222222000000222222200000000002222222222222222222222222222222222222222222222222222222222222222222222222222222222222222222220",
    "00022222222000000222222200000000002222222222222222222222222222222222222222222222222222222222222222222222222222222222222222222220",
    "00022222222000000222222200000000002222222222222222222222222222222222222222222222222222222222222222222222222222222222222222222220",
    "00022222222000000222222200000000002222222222222222222222222222222222222222222222222222222222222222222222222222222222222222222220",
    "00022222222000000222222200000000002222222222222222222222222222222222222222222222222222222222222222222222222222222222222222222220",
    "00022222222000000222222200000000002222222222222222222222222222222222222222222222222222222222222222222222222222222222222222222220",
    "00022222222222222222222200000000002222222222222222222222222222222222222222222222222222222222222222222222222222222222222222222220",
    "00022222222222222222222200000000002222222222222222222222222222222222222222222222222222222222222222222222222222222222222222222220",
    "00022222222222222222222200000000002222222222222222222222222222222222222222222222222222222222222222222222222222222222222222222220",
    "00022222222222222222222200000000002222222222222222222222222222222222222222222222222222222222222222222222222222222222222222222220",
    "00022222222222222222222200000000002222222222222222222222222222222222222222222222222222222222222222222222222222222222222222222220",
    "00022222222222222222222200000000002222222222222222222222222222222222222222222222222222222222222222222222222222222222222222222220",
    "00022222222000000222222200000000002222222222222222222222222222222222222222222222222222222222222222222222222222222222222222222220",
    "00022222222000000222222200000000002222222222222222222222222222222222222222222222222222222222222222222222222222222222222222222220",
    "00022222222000000222222200000000002222222222222222222222222222222222222222222222222222222222222222222222222222222222222222222220",
    "00022222222000000222222200000000002222222222222222222222222222222222222222222222222222222222222222222222222222222222222222222220",
    "00022222222000000222222200000000002222222222222222222222222222222222222222222222222222222222222222222222222222222222222222222220",
    "00022222222000000222222200000000002222222222222222222222222222222222222222222222222222222222222222222222222222222222222222222220",
    "00022222222000000222222200000000002222222222222222222222222222222222222222222222222222222222222222222222222222222222222222222220",
    "00022222222000000222222200000000000222222222222222222222222222222222222222222222222222222222222222222222222222222222222222222220",
    "00022222222000000222222200000000000000022222200000000000002222222222222200000000222222220000000000000000000000000000000000000000",
    "00022222222000000222222200000000000000022222200000000000002222222222222200000000222222220000000000000000000000000000000000000000",
    "00022222222000000222222200000000000000022222200000000000002222222222222200000000222222220000000000000000000000000000000000000000",
    "00022222222000000222222200000000000000022222200000000000002222222222222200000000222222220000000000000000000000000000000000000000",
    "00022222222000000222222200000000000000022222200000000000002222222222222200000000222222220000000000000000000000000000000000000000",
    "00022222222000000222222200000000000000022222200000000000002222222222222200000000222222220000000000000000000000000000000000000000",
    "00022222222222222222222200000000000000022222200000000000002222222222222200000000222222220000000000000000000000000000000000000000",
    "00022222222222222222222200000000000000022222200000000000002222222222222200000000222222220000000000000000000000000000000000000000",
    "00022222222222222222222200000000000000022222200000000000002222222222222200000000222222220000000000000000000000000000000000000000",
    "00022222222222222222222200000000000000022222200000000000002222222222222200000000222222220000000000000000000000000000000000000000",
    "00000000000000000222222200000000000000022222200000000000002222222222222200000000222222220000000000000000000000000000000000000000",
    "00000000000000000222222200000000000000022222200000000000002222222222222200000000222222220000000000000000000000000000000000000000",
    "00000000000000000222222200000000000000022222200000000000002222222222222200000000222222220000000000000000000000000000000000000000",
    "00000000000000000222222200000000000000022222200000000000002222222222222200000000222222220000000000000000000000000000000000000000",
    "00000000000000000222222200000000000000022222200000000000002222222222222200000000222222220000000000000000000000000000000000000000",
    "00000000000000222222222222222222222222222222222222222220002222222222222200000000222222220000000000000000000000000000000000000000",
    "00000000000000222222222222222222222222222222222222222220002222222222222200000000222222220000000000000000000000000000000000000000",
    "00000000000000222222222222222222222222222222222222222220002222222222222200000000222222220000000000000000000000000000000000000000",
    "00000000000000222222222222222222222222222222222222222220002222222222222200000002222222220000000000000000000000000000000000000000",
    "00000000000000222222222222222222222222222222222222222220002222222222222200022222222222222222222222222222222222222222222222222200",
    "00000000000000222222222222222222222222222222222222222220002222222222222200022222222222222222222222222222222222222222222222222200",
    "00000000000000222222222222222222222222222222222222222220002222222222222200022222222222222222222222222222222222222222222222222200",
    "00000000000000222222222222222222222222222222222222222220002222222222222200022222222222222222222222222222222222222222222222222200",
    "00000000000000222222222222222222222222222222222222222220002222222222222200022222222222222222222222222222222222222222222222222200",
    "00000000000000222222222222222222222222222222222222222220002222222222222200022222222222222222222222222222222222222222222222222200",
    "00000000000000222222222222222222222222222222222222222220002222222222222200022222222222222222222222222222222222222222222222222200",
    "00000000000000222222222222222222222222222222222222222220002222222222222200022222222222222222222222222222222222222222222222222200",
    "00000000000000222222222222222222222222222222222222222220002222222222222200022222222222222222222222222222222222222222222222222200",
    "00000000000000222222222222222222222222222222222222222220002222222222222200022222222222222222222222222222222222222222222222222200",
    "00000000000000222222222222222222222222222222222222222220002222222222222200022222222222222222222222222222222222222222222222222200",
    "00000000000000222222222222222222222222222222222222222220002222222222222200022222222222222222222222222222222222222222222222222200",
    "00000000000000222222222222222222222222222222222222222220002222222222222200022222222222222222222222222222222222222222222222222200",
    "00000000000000222222222222222222222222222222222222222220000222222222222200022222222222222222222222222222222222222222222222222200",
    "00000000000000222222222222222222222222222222222222222220000000000000000000022222222222222222222222222222222222222222222222222200",
    "00000000000000222222222222222222222222222222222222222220000000000000000000022222222222222222222222222222222222222222222222222200",
    "00000000000000222222222222222222222222222222222222222220000000000000000000022222222222222222222222222222222222222222222222222200",
    "00000000000000222222222222222222222222222222222222222222222222222222222222222222222222222222222222222222222222222222222222222200",
    "00000000000000222222222222222222222222222222222222222222222222222222222222222222222222222222222222222222222222222222222222222200",
    "00000000000000222222222222222222222222222222222222222222222222222222222222222222222222222222222222222222222222222222222222222200",
    "00000000000000222222222222222222222222222222222222222222222222222222222222222222222222222222222222222222222222222222222222222200",
    "00000000000000222222222222222222222222222222222222222222222222222222222222222222222222222222222222222222222222222222222222222200",
    "00000000000000222222222222222222222222222222222222222220000000000000000000022222222222222222222222222222222222222222222222222200",
    "00000000000000222222222222222222222222222222222222222220000000000000000000022222222222222222222222222222222222222222222222222200",
    "00000000000000222222222222222222222222222222222222222220000000000000000000022222222222222222222222222222222222222222222222222200",
    "00000000000000222222222222222222222222222222222222222220000000000000000000022222222222222222222222222222222222222222222222222200",
    "00000000000000222222222222222222222222222222222222222220000000000000000000000000000000000000000000000000000000000022222220000000",
    "00000000000000222222222222222222222222222222222222222220000000000000000000000000000000000000000000000000000000000022222220000000",
    "00000000000000222222222222222222222222222222222222222220000000000000000000000000000000000000000000000000000000000022222220000000",
    "00000000000000222222222222222222222222222222222222222220000000000000000000000000000000000000000000000000000000000022222220000000",
    "00000000000000222222222222222222222222222222222222222220000000000000000000000000000000000000000000000000000000000022222220000000",
    "00000000000000222222222222222222222222222222222222222220000000000000000000000000000000000000000000000000000000000022222220000000",
    "00000000002222222222222222222222222222222222222222222222222222222222222222222222222222222222222222222222222222222222222220000000",
    "00000000002222222222222222222222222222222222222222222222222222222222222222222222222222222222222222222222222222222222222220000000",
    "00000000002222222222222222222222222222222222222222222222222222222222222222222222222222222222222222222222222222222222222220000000",
    "00000000002222222222222222222222222222222222222222222222222222222222222222222222222222222222222222222222222222222222222220000000",
    "00000000002222222222222222222222222222222222222222222222222222222222222222222222222222222222222222222222222222222222222220000000",
    "00000000002222222222222222222222222222222222222222222222222222222222222222222222222222222222222222222222222222222222222220000000",
    "00000000002222222222222222222222222222222222222222222222222222222222222222222222222222222222222222222222222222222222222220000000",
    "00000000002222222222222222222222222222222222222222222222222222222222222222222222222222222222222222222222222222222222222220000000",
    "00000000002222222222222222222222222222222222222222222222222222222222222222222222222222222222222222222222222222222222222220000000",
    "00000000002222222222222222222222222222222222222222222222222222222222222222222222222222222222222222222222222222222222222220000000",
    "00000000002222222222222222222222222222222222222222222222222222222222222222222222222222222222222222222222222222222222222220000000",
    "00000000002222222222222222222222222222222222222222222222222222222222222222222222222222222222222222222222222222222222222220000000",
    "00000000002222222222222222222222222222222222222222222222222222222222222222222222222222222222222222222222222222222222222220000000",
    "00000000002222222222222222222222222222222222222222222222222222222222222222222222222222222222222222222222222222222222222220000000",
    "00000000002222222222222222222222222222222222222222222222222222222222222222222222222222222222222222222222222222222222222220000000",
    "00000000000000000000000000000000000000000000000000000000000000000000000000000000000000000000000000000000000000000000000000000000",
    "00000000000000000000000000000000000000000000000000000000000000000000000000000000000000000000000000000000000000000000000000000000",
    "00000000000000000000000000000000000000000000000000000000000000000000000000000000000000000000000000000000000000000000000000000000",
    "00000000000000000000000000000000000000000000000000000000000000000000000000000000000000000000000000000000000000000000000000000000",
    "00000000000000000000000000000000000000000000000000000000000000000000000000000000000000000000000000000000000000000000000000000000"
  ],
  "agent_spawn_pool": [
    [88, 20],
    [85, 48],
    [20, 65],
    [102, 114]
  ],
  "npc_spawn_pool": [
    [6, 17],
    [65, 80],
    [42, 85],
    [117, 88]
  ],
  "station_pool": [{"x": 109, "z": 19, "dx": 3, "dz": 3}, {"x": 61, "z": 42, "dx": 3, "dz": 3}, {"x": 97, "z": 93, "dx": 3, "dz": 3}, {"x": 26, "z": 103, "dx": 3, "dz": 3}],
  "max_battery": 200,
  "max_steps": 1000,
  "hero_id": 37,
  "npc_ids": null,
  "local_view_size": 21
}
