{
  "schema_version": 1,
  "map_id": 3,
  "size": [128, 128],
  "custom_map": [
    "00000000000000000000000000000000000000000000000000000000000000000000000000000000000000000000000000000000000000000000000000000000",
    "02222222222222222222222222222222222222222222222222222222222222200222222222222222222222222222222222222222222222222222222222222220",
    "02222222222222222222222222222222222222222222222222222222222222200222222222222222222222222222222222222222222222222222222222222220",
    "02222222222222222222222222222222222222222222222222222222222222200222222222222222222222222222222222222222222222222222222222222220",
    "02222222222222222222222222222222222222222222222222222222222222200222222222222222222222222222222222222222222222222222222222222220",
    "02222222222222222222222222222222222222222222222222222222222222200222222222222222222222222222222222222222222222222222222222222220",
    "02222222222222222222222222222222222222222222222222222222222222200222222222222222222222222222222222222222222222222222222222222220",
    "02222222222222222222222222222222222222222222222222222222222222200222222222222222222222222222222222222222222222222222222222222220",
    "02222222222222222222222222222222222222222222222222222222222222200222222222222222222222222222222222222222222222222222222222222220",
    "02222222222222222222222222222222222222222222222222222222222222200222222222222222222222222222222222222222222222222222222222222220",
    "02222222222222222222222222222222222222222222222222222222222222200222222222222222222222222222222222222222222222222222222222222220",
    "02222222222222222222222222222222222222222222222222222222222222200222222222222222222222222222222222222222222222222222222222222220",
    "02222222222222222222222222222222222222222222222222222222222222200222222222222222222222222222222222222222222222222222222222222220",
    "02222222222222222222222222222222222222222222222222222222222222200222222222222222222222222222222222222222222222222222222222222220",
    "02222222222222222222222222222222222222222222222222222222222222200222222222222222222222222222222222222222222222222222222222222220",
    "02222222222222222222222222222222222222222222222222222222222222200222222222222222222222222222222222222222222222222222222222222220",
    "02222222222222222222222222222222222222222222222222222222222222200222222222222222222222222222222222222222222222222222222222222220",
    "02222222222222222222222222222222222222222222222222222222222222200222222222222222222222222222222222222222222222222222222222222220",
    "02222222222222222222222222222222222222222222222222222222222222200222222222222222222222222222222222222222222222222222222222222220",
    "02222222222222222222222222222222222222222222222222222222222222200222222222222222222222222222222222222222222222222222222222222220",
    "02222222222222222222222222222222222222222222222222222222222222200222222222222222222222222222222222222222222222222222222222222220",
    "02222222222222222222222222222222222222222222222222222222222222200222222222222222222222222222222222222222222222222222222222222220",
    "02222222222222222222222222222222222222222222222222222222222222200222222222222222222222222222222222222222222222222222222222222220",
    "02222222222222222222222222222222222222222222222222222222222222200222222222222222222222222222222222222222222222222222222222222220",
    "02222222222222222222222222222222222222222222222222222222222222200222222222222222222222222222222222222222222222222222222222222220",
    "02222222222222222222222222222222222222222222222222222222222222200222222222222222222222222222222222222222222222222222222222222220",
    "02222222222222222222222222222222222222222222222222222222222222200222222222222222222222222222222222222222222222222222222222222220",
    "02222222222222222222222222222222222222222222222222222222222222200222222222222222222222222222222222222222222222222222222222222220",
    "02222222222222222222222222222222222222222222222222222222222222200222222222222222222222222222222222222222222222222222222222222220",
    "02222222222222222222222222222222222222222222222222222222222222200222222222222222222222222222222222222222222222222222222222222220",
    "02222222222222222222222222222222222222222222222222222222222222200222222222222222222222222222222222222222222222222222222222222220",
    "02222222222222222222222222222222222222222222222222222222222222222222222222222222222222222222222222222222222222222222222222222220",
    "02222222222222222222222222222222222222222222222222222222222222222222222222222222222222222222222222222222222222222222222222222220",
    "02222222222222222222222222222222222222222222222222222222222222222222222222222222222222222222222222222222222222222222222222222220",
    "02222222222222222222222222222222222222222222222222222222222222200222222222222222222222222222222222222222222222222222222222222220",
    "02222222222222222222222222222222222222222222222222222222222222200222222222222222222222222222222222222222222222222222222222222220",
    "02222222222222222222222222222222222222222222222222222222222222200222222222222222222222222222222222222222222222222222222222222220",
    "02222222222222222222222222222222222222222222222222222222222222200222222222222222222222222222222222222222222222222222222222222220",
    "02222222222222222222222222222222222222222222222222222222222222200222222222222222222222222222222222222222222222222222222222222220",
    "02222222222222222222222222222222222222222222222222222222222222200222222222222222222222222222222222222222222222222222222222222220",
    "02222222222222222222222222222222222222222222222222222222222222200222222222222222222222222222222222222222222222222222222222222220",
    "02222222222222222222222222222222222222222222222222222222222222200222222222222222222222222222222222222222222222222222222222222220",
    "02222222222222222222222222222222222222222222222222222222222222200222222222222222222222222222222222222222222222222222222222222220",
    "02222222222222222222222222222222222222222222222222222222222222200222222222222222222222222222222222222222222222222222222222222220",
    "02222222222222222222222222222222222222222222222222222222222222200222222222222222222222222222222222222222222222222222222222222220",
    "02222222222222222222222222222222222222222222222222222222222222200222222222222222222222222222222222222222222222222222222222222220",
    "02222222222222222222222222222222222222222222222222222222222222200222222222222222222222222222222222222222222222222222222222222220",
    "02222222222222222222222222222222222222222222222222222222222222200222222222222222222222222222222222222222222222222222222222222220",
    "02222222222222222222222222222222222222222222222222222222222222200222222222222222222222222222222222222222222222222222222222222220",
    "02222222222222222222222222222222222222222222222222222222222222200222222222222222222222222222222222222222222222222222222222222220",
    "02222222222222222222222222222222222222222222222222222222222222200222222222222222222222222222222222222222222222222222222222222220",
    "02222222222222222222222222222222222222222222222222222222222222200222222222222222222222222222222222222222222222222222222222222220",
    "02222222222222222222222222222222222222222222222222222222222222200222222222222222222222222222222222222222222222222222222222222220",
    "02222222222222222222222222222222222222222222222222222222222222200222222222222222222222222222222222222222222222222222222222222220",
    "02222222222222222222222222222222222222222222222222222222222222200222222222222222222222222222222222222222222222222222222222222220",
    "02222222222222222222222222222222222222222222222222222222222222200222222222222222222222222222222222222222222222222222222222222220",
    "02222222222222222222222222222222222222222222222222222222222222200222222222222222222222222222222222222222222222222222222222222220",
    "02222222222222222222222222222222222222222222222222222222222222200222222222222222222222222222222222222222222222222222222222222220",
    "02222222222222222222222222222222222222222222222222222222222222200222222222222222222222222222222222222222222222222222222222222220",
    "02222222222222222222222222222222222222222222222222222222222222200222222222222222222222222222222222222222222222222222222222222220",
    "02222222222222222222222222222222222222222222222222222222222222200222222222222222222222222222222222222222222222222222222222222220",
    "02222222222222222222222222222222222222222222222222222222222222200222222222222222222222222222222222222222222222222222222222222220",
    "02222222222222222222222222222222222222222222222222222222222222200222222222222222222222222222222222222222222222222222222222222220",
    "00000000000000000000000000000002220000000000000000000000000000000000000000000000000000000000000222000000000000000000000000000000",
    "00000000000000000000000000000002220000000000000000000000000000000000000000000000000000000000000222000000000000000000000000000000",
    "02222222222222222222222222222222222222222222222222222222222222200222222222222222222222222222222222222222222222222222222222222220",
    "02222222222222222222222222222222222222222222222222222222222222200222222222222222222222222222222222222222222222222222222222222220",
    "02222222222222222222222222222222222222222222222222222222222222200222222222222222222222222222222222222222222222222222222222222220",
    "02222222222222222222222222222222222222222222222222222222222222200222222222222222222222222222222222222222222222222222222222222220",
    "02222222222222222222222222222222222222222222222222222222222222200222222222222222222222222222222222222222222222222222222222222220",
    "02222222222222222222222222222222222222222222222222222222222222200222222222222222222222222222222222222222222222222222222222222220",
    "02222222222222222222222222222222222222222222222222222222222222200222222222222222222222222222222222222222222222222222222222222220",
    "02222222222222222222222222222222222222222222222222222222222222200222222222222222222222222222222222222222222222222222222222222220",
    "02222222222222222222222222222222222222222222222222222222222222200222222222222222222222222222222222222222222222222222222222222220",
    "02222222222222222222222222222222222222222222222222222222222222200222222222222222222222222222222222222222222222222222222222222220",
    "02222222222222222222222222222222222222222222222222222222222222200222222222222222222222222222222222222222222222222222222222222220",
    "02222222222222222222222222222222222222222222222222222222222222200222222222222222222222222222222222222222222222222222222222222220",
    "02222222222222222222222222222222222222222222222222222222222222200222222222222222222222222222222222222222222222222222222222222220",
    "02222222222222222222222222222222222222222222222222222222222222200222222222222222222222222222222222222222222222222222222222222220",
    "02222222222222222222222222222222222222222222222222222222222222200222222222222222222222222222222222222222222222222222222222222220",
    "02222222222222222222222222222222222222222222222222222222222222200222222222222222222222222222222222222222222222222222222222222220",
    "02222222222222222222222222222222222222222222222222222222222222200222222222222222222222222222222222222222222222222222222222222220",
    "02222222222222222222222222222222222222222222222222222222222222200222222222222222222222222222222222222222222222222222222222222220",
    "02222222222222222222222222222222222222222222222222222222222222200222222222222222222222222222222222222222222222222222222222222220",
    "02222222222222222222222222222222222222222222222222222222222222200222222222222222222222222222222222222222222222222222222222222220",
    "02222222222222222222222222222222222222222222222222222222222222200222222222222222222222222222222222222222222222222222222222222220",
    "02222222222222222222222222222222222222222222222222222222222222200222222222222222222222222222222222222222222222222222222222222220",
    "02222222222222222222222222222222222222222222222222222222222222200222222222222222222222222222222222222222222222222222222222222220",
    "02222222222222222222222222222222222222222222222222222222222222200222222222222222222222222222222222222222222222222222222222222220",
    "02222222222222222222222222222222222222222222222222222222222222200222222222222222222222222222222222222222222222222222222222222220",
    "02222222222222222222222222222222222222222222222222222222222222200222222222222222222222222222222222222222222222222222222222222220",
    "02222222222222222222222222222222222222222222222222222222222222200222222222222222222222222222222222222222222222222222222222222220",
    "02222222222222222222222222222222222222222222222222222222222222200222222222222222222222222222222222222222222222222222222222222220",
    "02222222222222222222222222222222222222222222222222222222222222200222222222222222222222222222222222222222222222222222222222222220",
    "02222222222222222222222222222222222222222222222222222222222222200222222222222222222222222222222222222222222222222222222222222220",
    "02222222222222222222222222222222222222222222222222222222222222222222222222222222222222222222222222222222222222222222222222222220",
    "02222222222222222222222222222222222222222222222222222222222222222222222222222222222222222222222222222222222222222222222222222220",
    "02222222222222222222222222222222222222222222222222222222222222222222222222222222222222222222222222222222222222222222222222222220",
    "02222222222222222222222222222222222222222222222222222222222222200222222222222222222222222222222222222222222222222222222222222220",
    "02222222222222222222222222222222222222222222222222222222222222200222222222222222222222222222222222222222222222222222222222222220",
    "02222222222222222222222222222222222222222222222222222222222222200222222222222222222222222222222222222222222222222222222222222220",
    "02222222222222222222222222222222222222222222222222222222222222200222222222222222222222222222222222222222222222222222222222222220",
    "02222222222222222222222222222222222222222222222222222222222222200222222222222222222222222222222222222222222222222222222222222220",
    "02222222222222222222222222222222222222222222222222222222222222200222222222222222222222222222222222222222222222222222222222222220",
    "02222222222222222222222222222222222222222222222222222222222222200222222222222222222222222222222222222222222222222222222222222220",
    "02222222222222222222222222222222222222222222222222222222222222200222222222222222222222222222222222222222222222222222222222222220",
    "02222222222222222222222222222222222222222222222222222222222222200222222222222222222222222222222222222222222222222222222222222220",
    "02222222222222222222222222222222222222222222222222222222222222200222222222222222222222222222222222222222222222222222222222222220",
    "02222222222222222222222222222222222222222222222222222222222222200222222222222222222222222222222222222222222222222222222222222220",
    "02222222222222222222222222222222222222222222222222222222222222200222222222222222222222222222222222222222222222222222222222222220",
    "02222222222222222222222222222222222222222222222222222222222222200222222222222222222222222222222222222222222222222222222222222220",
    "02222222222222222222222222222222222222222222222222222222222222200222222222222222222222222222222222222222222222222222222222222220",
    "02222222222222222222222222222222222222222222222222222222222222200222222222222222222222222222222222222222222222222222222222222220",
    "02222222222222222222222222222222222222222222222222222222222222200222222222222222222222222222222222222222222222222222222222222220",
    "02222222222222222222222222222222222222222222222222222222222222200222222222222222222222222222222222222222222222222222222222222220",
    "02222222222222222222222222222222222222222222222222222222222222200222222222222222222222222222222222222222222222222222222222222220",
    "02222222222222222222222222222222222222222222222222222222222222200222222222222222222222222222222222222222222222222222222222222220",
    "02222222222222222222222222222222222222222222222222222222222222200222222222222222222222222222222222222222222222222222222222222220",
    "02222222222222222222222222222222222222222222222222222222222222200222222222222222222222222222222222222222222222222222222222222220",
    "02222222222222222222222222222222222222222222222222222222222222200222222222222222222222222222222222222222222222222222222222222220",
    "02222222222222222222222222222222222222222222222222222222222222200222222222222222222222222222222222222222222222222222222222222220",
    "02222222222222222222222222222222222222222222222222222222222222200222222222222222222222222222222222222222222222222222222222222220",
    "02222222222222222222222222222222222222222222222222222222222222200222222222222222222222222222222222222222222222222222222222222220",
    "02222222222222222222222222222222222222222222222222222222222222200222222222222222222222222222222222222222222222222222222222222220",
    "02222222222222222222222222222222222222222222222222222222222222200222222222222222222222222222222222222222222222222222222222222220",
    "02222222222222222222222222222222222222222222222222222222222222200222222222222222222222222222222222222222222222222222222222222220",
    "02222222222222222222222222222222222222222222222222222222222222200222222222222222222222222222222222222222222222222222222222222220",
    "00000000000000000000000000000000000000000000000000000000000000000000000000000000000000000000000000000000000000000000000000000000"
  ],
  "agent_spawn_pool": [
    [2, 2],
    [2, 125],
    [125, 2],
    [125, 125]
  ],
  "npc_spawn_pool": [
    [32, 32],
    [96, 32],
    [32, 96],
    [96, 96]
  ],
  "station_pool": [{"x": 2, "z": 2, "dx": 3, "dz": 3}, {"x": 123, "z": 2, "dx": 3, "dz": 3}, {"x": 2, "z": 123, "dx": 3, "dz": 3}, {"x": 123, "z": 123, "dx": 3, "dz": 3}],
  "max_battery": 200,
  "max_steps": 1000,
  "hero_id": 37,
  "npc_ids": null,
  "local_view_size": 21
}
